제품 도 너무 너무 맘 에 들 ㄴ답니다	<P>
집사 라 미 드럼 세탁기 를 싫 어 하 ㅂ니다	<N>
너무 좋 아요	<P>
조금 작 은 감 이 있 지만 잘 쓰 ㄹ께 요	<N>
통 돌 이 너무너무 조왕	<P>
꺼 사면 또 그 완전 불 친절 하 ㄴ 아저씨 가 또 수리 하 러 올 거 같 아 서 요	<N>
잘 빨리 지 도 않 고 전기세 도 많이 들어가 ㄴ다고 그래서 통 돌 이 시키 었 는데 가격 도 저렴 하 고 아주 좋 아요	<P>
정말 오래 기다리 어서 받 았 어요	<N>
잘 받 았 고 요	<P>
더 얼마나 기다리 어야 하 나요	<N>
만족 하 ㅂ니다	<P>
다만 치 고는 세탁물 들어가 는 양 이 좀 적 은 듯	<N>
가격 대비 매우 만족 하 ㅂ니다	<P>
가격 배송 다 맘 에 들 는데 설치 를 우리 가 다시 하 아야 되 겠 네요	<N>
덥 ㄴ데 감사 드리 어요	<P>
걱정 이 ㅂ니다	<N>
근데 새로 오 ㄴ 제품 사용 하 아 보 니 잘 돌아가 고 암튼 만족 이 ㅂ니다	<P>
그런데 어제 세탁 하 다 보 니 고정 하 았 다던 세탁기 가 혼자 서 센치를 걷 어 나오 았 어요	<N>
배송 하 시 는 분 들 이 친절 하 게 수평 다 맞추 어 주 시 어서 감사 하 ㅂ니다	<P>
구 정전 에 구매 하 ㄴ 것 이 라 배송이 늦 은 것 은 알 고 있 었 지만 배송 관련 하 여 안내 하 시 는 분 이 전화번호 를 알리 어 주 며 그쪽 으로 전화 하 면 정확 하 ㄴ 배송 날짜 를 알 수 있 다 하 여 전화 를 드리 었 더니만 그쪽 판매자 분 의 무 성의 하 ㄴ 전화 통화 에 화가 나 았 습니다	<N>
소음 도 적 고 좋 네요	<P>
구정 때 는 배송이 그럴려니하야지 빨 랴 야 주일 걸릴거닌까 기다리 시 어요 하 며 질문 에 똑같 은 말 만 하 는 판매자 분 의 말 등	<N>
매우 만족 하 ㅂ니다	<P>
벌 ㄴ가 담당자 분 께서 이런 점 을 지적 하 여 저 아니 ㄴ 다른 분 들 까지 기분 이 상하 는 일 이 없 으면 하 여 몇 자 적 어 보내 ㅂ니다	<N>
제 가 시간 이 안 되 어서 참 맞추 기 힘들엇는데도끝까지최선을 다 하 아 주 시 어서 감사 하 ㅂ니다	<P>
그런데 키로 사이즈 아니 ㄴ 것 같이 넘작네여	<N>
좋 네요	<P>
배송 일자 를 요구 사항 에 기재 하 았 는데 요청 한 날자 에 도 소식 이 없 어 연락 하 았 더니 재고 가 없 다는 황당 하 ㄴ 말 을 들 었 습니다	<N>
설치 하 시 는 분 도 친절 하 시 고 세탁기 도 맘 에 들 어요	<P>
몇 번 을 전화 하 았 지만 일주일 주문 은 월 이 ㄹ 도착 요청 한 날 월일 뒤 에 배송 되 ㄴ다 하 여 주문 취소 하 ㄴ다 하 았 더니 그 다음날 배송 되 어 오 았 더군 요	<N>
지 마켓 만원 할인 쿠폰 을 이용 하 아서 싸 게 사 아서 더욱 좋 구요	<P>
하 기 로 절 때 아니 ㅂ니다	<N>
근데 무지 조용 하 구 예쁘데요	<P>
대우 께 고장 드럽 게 잘 나 기 로 소문났짢아여	<N>
적극 추천 하 ㅂ니다	<P>
근데 소음 이 좀 이 었 네요	<N>
식구 많 지 않 구 특히혼자 살 시 는 분 이 아이 몸집 이 작 구 예쁘 다 하 니 딱 이 ㄴ 거 같 네요	<P>
생각 외 로 란 것 이 체감 하 기 에 는 작 네요	<N>
대 만족	<P>
통 돌 이 과 는 다르 게 드럼 짜리 는 용량 이 너무 작 아서 옷 몇 개 안 들어가 아 내 요	<N>
아주 좋 음	<P>
탈수 하 ㄹ 때 소리 도 무지 크 내 요	<N>
디자인 도 깔끔 하 니 좋 아요	<P>
기사 아저씨 가 옷 을 많이 넣 어서 소리 가 크 게 날수 있 다고 하 시 어서 티 몇 장 만 넣 고 하 았 는데도 탈수 소리 가 무지 크 내 요	<N>
택배 기사 분 도 친절 하 시 고	<P>
가격 대비 괜찮은데생각보단 소음 이 좀 심하 네 요	<N>
잘 빨리 고 좋 네요	<P>
작 기 도 하 고	<N>
무게 도 가볍 아 위치 변경 하 기 도 좋 아요	<P>
혼자 살 는 사람 에게 ㄴ 적당 하 아도 가족 이 있 는 집 은 좀 적 을 듯 하 네 요	<N>
마켓너무좋네요	<P>
전 에 사용 하 던 세탁기 또한 대우 클라세 짜리 드럼 이 이 었 는데 뭐 가 문제 인지 소 음	<N>
배송 이 정말 빠르 ㅂ니다	<P>
자주 전원 이 차단 되 고	<N>
그래서 더 좋 은 것 같 아요	<P>
건조 기능 이 없 는 거 ㄹ 선택 하 아서 좀 아쉽 기 ㄴ 하 지 만 요	<N>
빨래도잘되고여러모로마음에듭니다	<P>
소음 이 조금 있 는 것 같 네요	<N>
안심 하 시 어도 되 어요	<P>
단 이번 에 는 배송이 일주일 이나 걸리 어 불편 하 았 습니다	<N>
기사 님 도 친절 하 시 게 바닥 에 기스날까봐 들 어서 아주 깔끔 하 게 설치 하 아 주 시 고 가시 었 답니다	<P>
단 너무 조그만하 아서 세대 인원 이 많 은 집 에서 는 사용 하 기 어렵 ㄹ 것 같 습니다	<N>
월래 댓글 만 보 구 후기 작성 안 하 는데 너무 조 아 서 올리 ㅂ니다	<P>
탈수 시 통 이 돌아가 ㄹ 때 모터 소음 은 시끄럽 습니다	<N>
탈수 할 때 약간 소음 이 심하 기 는 하 지만 이 정도 가격 에 정말 정말 훌륭 하 고 착하 ㄴ 제품 이 ㅂ니다	<P>
어느 면 에서 탈 수시 소음 이랑 이불 을 빨 ㄹ 때 간혹 세탁물 이 치우치 어 멈추 는 현상 에서 요	<N>
적극 추천 하 ㅂ니다	<P>
전 보다 훨 나아지 었 다는 느낌 은 들 지 않 았 어요	<N>
디자인 이나 기능 면 이 완전 맘 에 쏙 들 어요	<P>
무게 는 그렇 게 무겁 지 가 아 않 아서 떨리 ㅁ 이 조금 심 하 네 여	<N>
소음 적 고 빨래 잘 되 고 잘 살 ㄴ 것 같 아요	<P>
가격 대비 제 가 생각 하 기 에 는 좀 별루	<N>
기사 아저씨 도 친절 하 시 었 다고 하시더군요집에 없 어서	<P>
전 핑크색 구입 하 았 는데 피그먼트가 뭐 이 ㄴ지 정확 하 게 모르 아서 그랬는지별루네요	<N>
배송 에 감동 감동	<P>
배송비 포함 원 이 면 그다지 쌓 ㄴ 건 아니 ㄴ 거 같 은데	<N>
물건 받 은 다음날 본사 에서 확인 전화 도 받 았 고 서비스 부분 에서 도 만족 만족	<P>
누빔 이 군데군데 되 어 있 어서 뜨 는 것 같 은 느낌 이	<N>
세탁기 잘 살 ㄴ 것 같 아요	<P>
뭐 여튼 어제 받 았 는데 아직 쓰 던 이불 버리 지 ㄹ 않 아서 덮 어 보 지 ㄴ 않 았 지만 가격 대비 그럭저럭 인 것 같 습니다	<N>
설치 도 잘 하 아 주 시 었 고 헌 세탁기 도 수거 하 아 주 시 었 어요	<P>
통 돌 이 비하 아서 좀 적 게 들어가 기 ㄴ 하 네 여	<N>
우리 가 없 어 걱정 하 았 는데 친절 하 게 하 아 주 시 었 네요	<P>
가격 대 에 비하 아 제품 의 지리 다소 미흡	<N>
원하 는 시간 에 맞추 어서 설치 하 아서 좋 았 음	<P>
잡다 하 ㄴ 기능 이 좀 많 기 도 한 것 같 구	<N>
드럼 보다 시원 하 게 세탁 이 되 는 것 같 아 좋 음	<P>
배송이 주일만 에 오 았 다는 것 도 좀 그렇 구	<N>
가격 대비 성능 기대 이상	<P>
탈수 헹구 ㅁ 세탁 시간 조정 이 안 되 는 것 이 좀	<N>
배송 기사 님 의 완벽 하 ㄴ 설치 및 제품 설명 그리고 친절 하 ㄴ 님	<P>
가격 도 싸 고 배송 도 빠르 고 좋 은데 다른 회사 것 과 비교 하 아서 통 이 좀 적 은 것 같 습니다	<N>
아저씨 가 설치 잘 하 아 주 시 고 가시 고 다 맘 에 들 네 요	<P>
한가지 아쉽 ㄴ 것 이 용량 이 이 라 크 ㄹ 줄 알 았 는데 생각 보다 작 네요	<N>
나 잔 고장 걱정 하 면서 사 길 ㄴ 하 었 는데 지금 기분 으로 다 괜찮 을 듯 하 ㄴ 기분	<P>
다만 배송이 느리 었 다는 거	<N>
사 제품 만 쭈욱 사용 하 다가 이사 하 면서 로 바꾸 었 는데 너무 맘 에 들 어요	<P>
다른 분 들 이 말 하 ㄴ 거 처럼 탈수 되 ㄹ 때 나 는 소음 이 정말 비행 이 이착륙소리같다능거	<N>
늘 깜빡 하 곤 하 았 는데 너무 좋 네요	<P>
가격 도 싸 고 좋 은데 전 에 쓰 던 것 고 대우공기방울이고 잇 었 는데 이번거랑 크기 차이 가 좀 많이 나 네 요	<N>
세탁 도 시원시원 하 게 잘 돌아가 고 너무 맘 에 들 ㅂ니다	<P>
너무 늦 게 오시 길 ㄴ 하 었 지만	<N>
생각 보다 작 은데 빨래 는 잘 되 는 것 같 네요	<P>
한가지 흠 은 기능 이 생각 하 았 던 것 보다 쫌 덜 다양 하 네 요	<N>
친절 하 ㄴ 기사 님 이 설치 도 이쁘 게 해주셧구요	<P>
단 배송 이 좀 느리 지만	<N>
좋 아요	<P>
미리 전화 주 시 면 더욱 감사 하 았 을 터 이 ㄴ데 당일 날 출근 하 아서 야 아신 다니 고것 이 약간 에로 점 이 라면 에로 에 요	<N>
추천 하 ㅂ니다	<P>
근데 모터 소음 이 좀 크 기 ㄴ 하 아요	<N>
설치 기사 님 좋 고 친절 하 ㅂ니다	<P>
가격 도 좋 고 품질 은 잘	<N>
할머니 사 드리 었 는데 아주 좋아하 시 ㅂ니다	<P>
단 소음 은 좀 크 ㄴ 편 이 네요	<N>
좋 아요	<P>
가격 및 디자인 매우 만족 스럽 나 솔직히 소음 은 조금 불만	<N>
만족 스럽 고 배송 이나 설치 기사 분 들 도 친절 하 시 고 좋 았 어요	<P>
가격 에 비하 아 좋 은 것 ㄴ 사실 이 지만 좀 작 아서 이불 빨래 는 못하 ㄹ 것 같 습니다	<N>
송 도 빠르 고 잘 설치 하 아 주 시 고 빨래 돌려R는데 좋 은 거 같 아 여	<P>
배송 은 끈기 가 있 어야 기다리 겠 더군 요	<N>
좋 아요	<P>
가격 은 실속 있 고 디자인 이나 크기 는 적당 하 고 서비스 는 친절 하 고 탈 수시 물 빠지 는 소리 나 소음 이 일 반 세탁기 보다 조금 크 다는 것 만 빼 고는 괜찮 은 것 같 아요	<N>
정말 좋 아 요	<P>
조작 매우 간단 불림 코스 가 따로 없 어서 당황했슴	<N>
진짜 좋 아 여 후회 안 하 시 ㅁ 당	<P>
드럼 쓰 다 일반 사용 하 니 더 실용 적 이 ㄴ 듯함 시간 전기세 등	<N>
기분 넘 조 아	<P>
그렇다면 받침대 도 일종 의 부속 이 되 어야 되 는 것 아닙니까	<N>
물건 은 좀 늦 었 지만 그래두 설치 기사 님 이 매우 만족 스럽 게 설치 하 시 어서 고맙 습니다	<P>
얼렁뚱땅 대강 의 정신 에 는 좀 짜증 이 나 는군 요	<N>
배송 하 시 는 분 넘 친절하심돠	<P>
세탁기 구입 하 시 ㄹ 분 들 그런 점 도 유념 하 시 어야 되 ㄹ 것 같 습니다	<N>
가격 도 넘 좋 았 고 아자씨 의 친절 함 이 좋 았 고 배송 역 시 좋았슴	<P>
물론 최 상급 기종 이야 다 갖추 었 겠 지만 필요 하 ㄴ 기능 만큼 만 쓰 는 것 이 니까요	<N>
넘 조 아	<P>
일 후 에 연락 오 았 는데 물품 수량 이 딸리 어서 주일 기 다리 라 네 여	<N>
만족해욤	<P>
예전 에 쓰 던 세탁기 는 하 ㄴ 년 이 달 되 가 는 거 이 었 고 삼성꺼였는데 예전 에 쓰 던 것 보다 소음 이 조금 나 네 요	<N>
좋 아요	<P>
전철 소리 비슷 하 ㄴ	<N>
색 갈 아도 이쁘 고 튼실 하 니 매일 매일 빨래 하 아요	<P>
그래서 낮 시 쯤 에 오 시 ㄴ다 하 시 어서 그래서 쪼금 불편 하 았 구요	<N>
정말 정말 좋 아요	<P>
분 이 오 시 어서 무겁 ㄴ 세탁기 를 들 고 오 시 고 오래되 ㄴ 세탁기 도 잘 수거 하 아 가 아 주 시 어서 감사 하 았 어요	<N>
특히 배송 기사 아조 씨 넘 넘 친절 하 시 고 요	<P>
배송 이 심하 게 늦 네요	<N>
설명 도 잘 하 아 주 시 고 구 세탁기 도 수거 하 아 가시 는 점 이 넘넘 맘 에 들 어요	<P>
주문 하 았 는데 에 받 았 어요	<N>
배송기 간 도 빠르 고 설치 도 완벽 하 고 거기 다 상세 하 ㄴ 설명 까지	<P>
옷감 이 많이 상하 지 않 는 이 다고 하 던데 별로 그렇 지 ㄴ 않 은 것 같 고 면 가디건 니트 도 아니 ㄴ 데 빨 았 더니 약하 게 보플 일어나 았 어요	<N>
담 에 도 또 필요 하 면 여기 물건 이용 하 ㄹ래요	<P>
소음 은 좀 이 었 네요	<N>
여러분 도 망설이 지 마 세 요	<P>
배수구 가 위 로 나오 게 되 어 있 어서 그렇 대 요	<N>
제품 정말 저렴 하 고 좋 은 거 있죵	<P>
가격 이 싸 아서 선택 하 았 는데 소리가좀씨끄럽네요	<N>
좋 아요	<P>
그냥 물세탁 기 에 비하 아 물세 절약 하 ㄴ다 치 고 쓰 어야 하 겠 어요	<N>
배송 하 신분 들 이 설치 까지 하 아 주 시 고 가 시 어서 감사	<P>
가격 이 싸 아서 안 좋 으면 어쩌 나 걱정 하 았 는데 생각 보다 좋 아요	<N>
매장 보다 는 저렴 하 ㄴ 가격 으로 동일 하 ㄴ 제품 을 구매 하 게 되 어 너무 좋 아요	<P>
가격 이 저렴 하 ㄴ 것 에 비하 아 디자인 품질 모두 너무 좋 아요	<N>
디자인 과 품질 도 뛰어나 ㄴ 다이아몬드 를 보 는 순간 갖 고 싶 은 세탁기 이 었 는데 구입 하 아도 너무 좋 아요	<P>
근데 배송 이 너무 늦 네요	<N>
가 겨 대비 쓰 ㄹ 만 하 네 요	<P>
상품 설명서 도 없 고 하 자 있 는 물건 은 아니 겠 지요	<N>
가격 넘넘 싸 고 가격 대비 아주 만족 이 ㅂ니다	<P>
가격 이 비하 아 최고 이 ㄴ 거 같 은데 여	<N>
쌓 ㄴ 것 이 비지떡 이란 말 안 나오 면 정말 대 만족 일 이 ㅂ니다	<P>
근데 섬유린스 자동 투입 은 안 되 던 거 ㄹ 요	<N>
가격 다른 제품 과 비교 하 면 저렴 하 고 배송 빠르 고 세탁 잘 되 ㅂ니다	<P>
가격 저 렴 하 고 편리 하 며 세탁력 뛰 어 나 아요	<N>
가격 대비 강력 추천	<P>
탈수 시 소리 가 좀 나 는데 모타 소리 이 라니	<N>
디자인 좋 고 성능 도 좋 습니다	<P>
배달 하 아 주 시 는 대우전자 직원 분 들 은 상당히 친절 하 ㄴ데 말 이 죠	<N>
아파트 에서 사용 하 는데도 소음 이 크 어 지 어 않 네 요	<P>
근데 싼값 에 사 았 는데 몇일 못 기 다리 이 겠 는가 싶 어서 몇일 을 손 빨래 하 아 가 면서 기다리 었 습니다	<N>
내부 구조 도 잘 되 어 있 고 빨래 도 잘 되 ㅂ니다	<P>
무엇 이 든지 설마 하 는 생각 이 있 었 는데 배송 이 늦 는다 소음 이 크 다	<N>
사용 하 는데 어려움 없이 드럼 보다 통 돌 이 가 짱	<P>
이런저런 상품 평 보고 에 이 설마 세탁기 를 만들 어서 배송 하 는 것 도 아니 고 왜 늦 을까	<N>
가격 대비 넘 좋 습니다	<P>
드럼 이 ㄴ데 소음 이 크 ㄹ까 이 라는 생각	<N>
가격 대비 대 만족 일 이 ㅂ니다	<P>
덕분 에 더 좋 은 상품 을 구매 하 ㄹ 수 있 어서 너무 좋 았 습니다	<N>
굿	<P>
소음 이 조금 있 구 생각 보다 작 지만	<N>
가격 대비 만족 이 ㅂ니다	<P>
그래도 잘 쓰 겠 지만 번창 하 세 여	<N>
배송도 빠르 ㄴ 편 이 구요	<P>
갑자기 고장 나 아서 쇼핑몰 에서 는 배송이 넘느리고	<N>
직접 설치 하 아 주 시 고 선물 로 하 아 드리 었 는데 좋아하 시 어요	<P>
그래서 매장 을 가 았 는데 맘 에 들 는 것 이 있 는데 넘비싸서 손 빨래 하 ㄹ 각오 로 주문 하 았 는데	<N>
가격 대비 만족 하 ㅂ니다	<P>
세탁기 문 이 잘 안 열리 어요	<N>
가격 대비 맘 에 들 ㅂ니다	<P>
모르 아서 당황 하 았 는데 전원 이 들어가 아야 한참 있 다가 열 수 있 습니다	<N>
아직 세탁 은 않해 보 았 지만 맘 에 들 ㅂ니다	<P>
갑자기 세탁기 가 고장 나 는 바람 에 급하 게 주문 하 ㄴ 것 이 ㄴ데 하루 만 에 배송 하 아 주 시 어서 너무 감사 하 구요	<N>
설치 기사 님 도 친절 하 게 잘 설명 하 아 주 시 고 설치 도 잘 하 아 주 어서 감사 드리 ㅂ니다	<P>
크 ㄴ 이불 빨래 는 못하 ㄹ 것 같 다고 하 시 네요	<N>
가격 대비 매우 만족 하 ㅂ니다	<P>
같 은 모델 로 하이마트 등 오프라인 과 온라인 쇼핑몰 들 을 돌아다니 며 알아보 다 이 곳 에 서 주문 하 게 되 었 는데 어느 곳 과 비교 하 아 보 아도 정말 저렴 하 게 산 것 같 아요	<N>
가격 대비 베리 굿	<P>
가격 대비 만족 은 확실 하 ㅂ니다	<N>
가격 대비 상품 디자인 성능 기능 등 일단 만족	<P>
거의 일 먼저 결제 하 고 일 기다리 는 그 고통 도 생각 해 주 삼	<N>
가격 대비 상품 만족 하 ㅂ니다	<P>
거의 주 만 에 받 은 거 같 네요	<N>
가격 대비 성능 괜찮 네요	<P>
액체 이 라 기계 에 문제 는 없 겠 지만 쬐금 아쉽 었 습니다	<N>
어머니 가 그러 시 는데 전 에 세탁기 보다 때 가 더 잘 가 는 것 같 다고	<P>
겁나 게 잘 돌 아 가 네 여	<N>
가격 대비 성능 우수 하 ㄴ 듯 하 ㅂ니다	<P>
배송 은 늦 었 지만 상품 은 좋 은 것 같 네요	<N>
가격 대비 성능 짱	<P>
얼마나 가다려야 되 나요	<N>
좋 은 가격 에 좋 은 물건 이 네요	<P>
벌써 며칠 지나 아 버리 었 네요	<N>
가격 대비 하 아서 정말로 좋 아요	<P>
결제 하 고 기분 좋 아 있 는데 품절 이 라서 제품 수급 하 는데 시간 이 걸리 ㄹ 거 이 라는 전화 를 받 고 매우 상심 하 았 습니다	<N>
타제품 만큼 빨래 도 잘 되 는 것 같구여	<P>
쇼핑몰 에 상품 을 올리 ㄹ 때 는 카 파 부터 확인 하 시 어요	<N>
암튼 잘 살 ㄴ 것 같 아 염	<P>
그깐소음쯤이야머 감수 하 ㅂ니다	<N>
가격 디자인 모든 면 에서 맘 에 들 어요	<P>
요즘 것 은 괜찮 다고 하 지만 기본 적 으로 드럼 세탁 기 는 아이 들 이 있 는 집 에서 는 권하 고 싶 지 않 습니다	<N>
가격 만족 일 이 ㅂ니다	<P>
아이 들 이 자꾸 문 을 열 어서 들어가 려고 하 거나 문 에 올라타 아서 문 이 금새 틀어지 고 고장 나 기 일쑤 이 ㅂ니다	<N>
다 들 왜 드럼 세탁 기 를 살 는지 모르 겠 지만 전 사고 만족 하 았 습니다	<P>
게다가 세탁력 이 일 반 세탁기 에 비하 아 정도 밖 에 안빨리는것 같 습니다	<N>
가격 매우 만족	<P>
이번 통 돌 이 로 바꾸 고 나서 는 세탁력 이나 탈수 효과 도 엄청 좋 아 지 었 습니다	<N>
가격 면 에서 너무너무 좋 았 구요	<P>
그런데 판매자 하 고 전화 연결 이 안 되 어서 속 이 좀 타 았 습니다	<N>
성능면 에서 도 너무너무 좋 아요	<P>
요즈음 세상 이 좀 그렇찮아요	<N>
가격 배송 서비스 만족 하 ㅂ니다	<P>
배송 은 늦 은 것 은 물품 이 모자라 아서 그렇 다고 이해 하 더라도 구매자 가 문의 전화 를 하 면 판매자 께서 는 꼭 전화 를 받 아 주 시 었 으면 좋 겠 네요	<N>
가격 대비 상품 의 기능 이 마음 에 들 고 배송 도 많이 기다리 지 않 았 고 기사 분 의 서비스 도 친 절하 여 만족 스럽 네 요	<P>
아니 면 나중 에 확인 이 라도 하 시 고 구매자 에게 전화 를 주 시 던지	<N>
가격 싸 고 품질 좋 고 암튼 좋 아요	<P>
결혼 하 ㄹ 때 사 았 던 통 돌 이 세탁기 를 년 쓰 더니 한번 씩 돌리 ㄹ 때 이 면 소음 이 헬리콥터 지나가 는 줄 알 아요	<N>
가격 완전 짱 이 구요	<P>
계획 보다 너무 늦 어서 입 고 가 아 지연 되 어 페날티도 받 았 지만	<N>
품질 은 당근 요	<P>
하여튼 잘받았슴니다	<N>
넘 예쁘 어서 조 아 조 아 요	<P>
그럼 어떻 게 도와주려거나 멀 지 그런 느낌 의 태도 는 하나 도 보이 어 주 지 ㄹ 않 고 그냥 딱 자르 아서 가지 고 오 ㄴ 것 하나 에 가져가 ㄹ 것 도 하나 이 라고 만 말 하 고	<N>
거기 다가 설치 에 구 모델 수거 까지 해주닌까 베리 굿	<P>
어떻 게 노인 이 있 으니까 좀 더 도와주 는 것 같 은 거 없 어서 대우 서비스 는 내 가 돈 내 ㄴ 만큼 만 처리 되 는 것 이 지 그 이상 고객 만족 과 는 거리 가 멀다란 느낌 을 받 았 습니다	<N>
가격 저럼하고 빨래 잘 되 고 굿	<P>
뜨뜨 같 은 물건 을 사더라도뜨뜨 별루	<N>
가격 저렴 하 고 기계 도 깔끔 하 고 좋 네요	<P>
고맙 게 잘 쓰 겠 습니다	<N>
설치 기사 님 도 친절 하 고 좋 네요	<P>
괜찮 네요	<N>
크기 도 적당 하 고 디자인 도 참 좋 아요	<P>
괜찮 은 거 같았요	<N>
강력 추천 하 ㅂ니다	<P>
도 그렇 고 일단 탈락	<N>
가격 저렴 하 고 기계 도 깔끔 하 고 좋 네요	<P>
구입 하 ㄴ지 한달가까인데 계속 오 지 않 고 있 어요	<N>
세탁기 추천 하 ㅂ니다	<P>
취소 하 든지 빨리 보내 어 주 시 어요	<N>
가격 저렴 하 고 기계 도 깔끔 하 고 좋 네요	<P>
전화 필 이 바라 아 요	<N>
설치 기사 님 도 친절 하 고 좋 네요	<P>
가격 대비 만족 이 ㄴ 것 만 은 확실 하 ㅂ니다	<N>
크기 도 적당 하 고 디자인 도 참 좋 아요	<P>
잘 사용 하 지요	<N>
강력 추천 하 ㅂ니다	<P>
딱히 많이 세탁 하 ㄹ 것 도 없 으니까 필요 는 없 어요	<N>
가격 저렴 하 고 기계 도 깔끔 하 고 좋 네요	<P>
그 가격 대 에 드럽 세탁 기 성능 도 좋 고 배송 도 빠르 고 사업번창하세요	<N>
세탁기 참 좋 습니다	<P>
그냥 싼맛 에 산 걸 ㄴ데 몇 번 쓰 어 보 았 지만 사 시 ㄹ 드럼 세탁기 가 세탁 하 는 모양 이 영 맘 에 안 들 었 습니다	<N>
가격 저렴 하 고 디자인 괜찮 고 깨끗 하 고 배송 빠르 고 친절 하 고 굿 이 ㅁ	<P>
저렇 게 하 아서 빨래 가 되 나 하 고 생각 하 았었 는데 이상 하 게 빨래 이 다 되 어서 세탁 하 ㄴ걸 보 면 말끔 하 게 때 가 지우 어 지 어 있 더군요	<N>
가격 저렴 하 고 정말 좋 네요	<P>
디자인 도 좋 고 배송 도 좋 고 성능 은 아직 잘 모르 겠 고 암튼 가격 대비 좋 음	<N>
가격 저렴 하 여 좋 고	<P>
원래 쓰 던 거 랑 많이 틀리 어서 좀 어렵 네요	<N>
시험 세탁 하 아 보 니 만족 스럽 었 습니다	<P>
그냥 좋 다구 하 네 요	<N>
빨래 도 잘 돼네요	<P>
그냥 혼자 자취 하 면서 사용 하 기 딱이내요	<N>
무엇 보다 도 배송 하 아 주 시 ㄴ 기사 님 이 늦 은 시간 에 도 오 시 어서 설치 하 아 주 시 어 쓰 ㄴ 데 넘 친절 하 아서 감동 받 았 습니다	<P>
오지 이 라서 그러 ㄴ지 배송 은 좀 늦 어서	<N>
강추임돠	<P>
다른 점 은 모두 만족	<N>
가격 품질 만족 하 ㅂ니다	<P>
드럼 세탁 기도 좋 겠 지만 장단점 이 있 어 이 세탁기 를 구입 하 게 되 었 는데 좋 네요	<N>
가격 품질 배송 어디 하나 빠지 지 ㄹ 않 네 요	<P>
이젠 배송 때문 에 고객 들 지치 지 않 게 하 아 주 시 었 음 싶 네 요	<N>
넘 친절 한 배 송 에 가격 도 좋 고 완전 추천 하 ㅂ니다	<P>
저 렴 한 가 격 에 좋 은 제품 추천 하 ㅂ니다	<N>
가격 배송 설치 등등 모든 면 에서 만족스럽습니다	<P>
그런데 소음 이 무척 이나 심하 아요	<N>
특히 배송 하 여 주신 기사 분 정말 친절 하 시 었 다고 하 ㅂ니다	<P>
수평 을 안 ?嘯프致?	<N>
세탁기 를 구입 하 시 ㄹ 예정 이 시 ㄴ 분 들 에게 강력 추천 하 ㅂ니다	<P>
그런데로 괜찮 은 것 같 네요	<N>
가격 성능 배송 다 좋있습니다	<P>
근 데 별 로 추천 하 고 싶 지 않 네 요	<N>
가격 크기 소음 도 모두 만족	<P>
고객 센터 태도 가 넘맘에 안 들 네 요	<N>
가격 배 송 안내 등 다 만족 이 ㅂ니다	<P>
그런데로 괜찮 은 것 같 네요	<N>
가격배송폐가전수거 모두 모두 만족스럽습니다	<P>
근 데 별 로 추천 하 고 싶 지 않 네 요	<N>
가격빠른배송 만족 하 ㅂ니다	<P>
고객 센터 태도 가 넘맘에 안 들 네 요	<N>
디자인 도 이뻐요	<P>
그렇 게 시끄럽 지 두 않 던데 세탁기 가 그 정도 는 소리 나 는 것 이 당연한거아닌가요	<N>
가격 품질 색상 등 은 만족 하 ㅂ니다	<P>
요즘 은 세탁기 들 이 가볍 아 지 어서 불안 하 ㅂ니다	<N>
가격 배 송 품질 다 좋 으시 네요	<P>
탈 수 되 ㄹ 때 너무 흔들리 ㄴ다는 느낌 이 들 ㅂ니다	<N>
가격 과 디자인 괜찬고요	<P>
그래서 인지 엉킴이 없 습니다	<N>
아담 하 고 쓰 기에 편리 하 고 깔끔 하 ㄴ 것 이 좋 으시 네요	<P>
쌓 ㄴ 가격 만큼 정말 심플 하 군 요	<N>
가격 과 디자인 은 괜찮구여	<P>
근데 껍데기 가 좀 부실 하 네 요	<N>
가격 대 디자인 성능 만족 하 ㅂ니다	<P>
근데 배송 관리 는 엉성 하 ㄴ 듯	<N>
배송 기사 분 도 친절 하 시 고 작업 후 친절 하 ㄴ 설명 및 확인 감사 하 ㅂ니다	<P>
지난주 금요일 주문 전 에 판매자 에게 문의 결과 지금 주문 하 면 화 수요 일 에 도착 하 ㄴ다고 하 아서 주문 하 았 는데 화요일 에 판매자 분 이 전화 하 아서 목 토요일 에 배송 되 ㄴ다고 하 아서 주문 취소 하 았 는데 취소 하 자마자 기사분님이화요일 세탁기 들 고 오 았 다는	<N>
가격 대 비하 아 쓰 ㄹ 만 하 아요	<P>
다시 고객 센터 로 전화 걷 어서 주문 취소 하 ㄴ 거 다시 또 취소 하 고 여기저기 전화 걸 고 애먹 었 네요	<N>
다른 건 다 좋 아요	<P>
다행 이 물건 은 화요일 날 도착 하 아서 다행 이 ㅂ니다	<N>
가격 대 성능 면 에서 동급 ? 오 임 미 이 다	<P>
근데 생각 보다 작 네요	<N>
배송 하 시 는 분 도 빠르 고 약속 하 ㄴ 날짜 에 시간 까지 정확 하 고 친절 하 더군요	<P>
근데 설치 가 영 맘 에 안 들 어요	<N>
아주 마음 에 들 ㅂ니다	<P>
물 호수 도 길 ㄴ 것 준비 안 하 아 오 시 고 드라이버 도 알 ㄴ가 지 어 오 시 구 결국 호수 길이 에 맞 는 곳 에 설치 하 았 어요	<N>
가격 대 성능 비 는 좋 지만	<P>
그것 제외 하고 모두 맘 에 들 니 당	<N>
배송도 빠르 ㄴ 편 이 구요	<P>
불림 추천	<N>
가격 대비 괜찮 아요	<P>
그것 만 감수 하 ㄹ 수 있 다면 다른 건 다 만족 하 ㅂ니다	<N>
크기 가 작 아서 은 안 되 어 보이 지만 중국 산 살 는 가격 에 국산 세탁기 쓰 ㄹ 수 있 어서 좋 아요	<P>
결혼 앞두 고 볼일 이 좀 많 습니까	<N>
배송도 생각 보다 빠르 았 고 일 날 주문 하 아서 일 날 오 았 으니 만족 하 ㅂ니다	<P>
그럼 우리 가 설치 하 ㄹ 테 이 니 놓 고 만 가시 라고 하 었 습니다	<N>
강추	<P>
장난 하 ㅂ니까	<N>
가격 대비 너무 좋 은 상품 이 네요	<P>
제 가 잘못 보 았 나 싶 어서 상품 판매 페이지 오 아서 몇 번 이 고 다시 확인 하 았 습니다	<N>
가격 대비 너무 좋 습니다	<P>
결혼 일주일 앞두 고 넘넘 기분 나쁘 고 어이없 습니다	<N>
기사 님 도 친절 하 시 고 배송도 완전 빨리 오 았 네요	<P>
새로 구입 하 면 만원 그것 도 구형 급수 호수	<N>
가격 대비 넘 물건 이 좋 은 것 같 습니다	<P>
급하 게 사 았 는 데 소 리 는 보통 거 랑 똑같 고 깔끔 하 고 좋 은데 부분 세탁 이 안 되 는 듯	<N>
가격 대비 대 만족 이 ㅂ니다	<P>
급하 게 주문 하 았 는데 주문 시간 만 에 배송 을 하 아 주 시 다니 감사 하 ㅂ니다	<N>
뚜껑 이 투명 하 아서 세탁기 가 돌아가 는 동안 내용물 을 확인 하 ㄹ 수 있 어 너무 좋 아요	<P>
하지만 잘 때 세탁 기 돌리 면 소음 이 거슬림니다	<N>
가격 대비 대 만족 이 ㅂ니다	<P>
이렇 ㄹ 줄 알 았 다면 좀 더 크 ㄴ 것 ㄹ 사 ㄴ걸 그러 나 보 ㅂ니다	<N>
가격 대비 디자인 크기 실용 성 다 좋 아요	<P>
기다리 다 지치 어 버리 ㄴ 길 잃 은 작 은 영혼	<N>
외관 도 깨끗 하 아서 보 기 도 좋 고 조작 버튼 도 간편 하 아 어른 들 쓰기 에 딱 이 에요	<P>
기다리 다 목 빠지 는 줄	<N>
가격 대비 만족 하 ㅂ니다	<P>
배송 은 늦엇지만 제품은슬만 하 ㅁ	<N>
암튼 세탁 을 하 ㄹ 수 있 는 상황 이 아니 어 이번 에 ㄴ 좀 저렴 하 ㄴ걸 로 세탁 전용 으로 구매 하 었 는데 만족 하 ㅂ니다	<P>
배달해준다던날 전산 착오 로 물품 을 알 ㄴ가 지 고 나오 시 었 다구 나중 에 배달 하 아 주 ㄴ다구 그러 구 다른 분	<N>
이불 한번 빨 아 보 고 그리고 청바지 속옷 등 세탁 해보 았 는데 음 좋 네요	<P>
기사 님 친절 하 시 고 배송 은 그런대로 시간 ?上底 오 았 고	<N>
가격 대비 만족	<P>
통 돌 이 세탁기 의 단점 이 라고 는 하 는데 일단 드럼 세탁기 보다 는 소음 이 크 ㄴ 편 이 ㅂ니다	<N>
괜찮 습니다	<P>
그 외 에 는 대체로 만족 하 ㅂ니다	<N>
화이트 컬러 가 이쁘긷 하구 이 어	<P>
암튼 상품 은 굿 이 ㅂ니다	<N>
가격 대비 이 면 만족 하 ㅂ니다	<P>
늦 은 것 ㄴ 아닙니다만화요일주문 금요일 배 송 완료	<N>
가격 대비 만족 이 네요	<P>
생각 보다 많이 별 루 이 에요	<N>
가격 대비 만족 이 요	<P>
기사 님 의 친절 하 ㄴ 설명 이 인상 적 이 었 습니다	<N>
약간 의 소음 이 있 을 뿐 만족 스럽 네 요	<P>
그런데 세탁기 가 조금 약하 아요	<N>
가격 대비 만족 이 ㅂ니다	<P>
빨래 가 완전히 깨끗 하 게 는 안 빨 아 지 는 것 같 아요	<N>
가격 대비 만족 이 ㅂ니다	<P>
기사 님 이 오 시 면서 장미꽃 한 송이 를 주 시 네요	<N>
저렴 하 ㄴ 가격 에 드럼 세탁 기 를 구입 하 아서 좋 습니다	<P>
기사 분 설치 잘 하 아 주 시 고 물건 좋 습니다	<N>
가격 대비 만족 하 ㅂ니다	<P>
크기 도 작 고 좋 아요	<N>
가격 대비 만족 하 ㅂ니다	<P>
기존 하 고 차이 가 너무 나 네 요	<N>
가격 대비 만족 하 ㅂ니다	<P>
이불 도 안 들어가 겠 네요	<N>
독신자 자취 생 들 이 쓰기 에 좋 을 것 같 아	<P>
상담원 불 친절 하 ㄴ 태도 짜증	<N>
가격 대비 만족 하 ㅂ니다	<P>
박스 뜯 었 다고 반품 안 되 ㄴ다네 요	<N>
빠르 ㄴ 배송도 마음 에 들 ㅂ니다	<P>
이불 세탁 을 하 려고 다 들 용량 크 ㄴ 거 ㄹ 사 려는 거 아닌가요	<N>
세탁기 쓰 어 받 는데 정말 좋 네요	<P>
다른 물건 으로 교환 도 안 되 고 상담원 태도 는 너무 어이 없 더군요	<N>
가격 대비 만족 하 ㅂ니다	<P>
내 가 고르 ㄴ 물건 이 고 원하 아서 산거 이 니까 반품 이나 교환 이 안된다니요	<N>
가격 대비 만족 하 ㅂ니다	<P>
맘 에 안 들 면 바꾸 어 주 는 것 이 당연 하 ㄴ 거 아닌가요	<N>
색깔 도 이쁘 고 크기 도 적당 하 고 감사 하 ㅂ니다	<P>
배송 기사 님 도 같이 보이 냐고 묻 으니까 대답 못하 시 던데	<N>
가격 대비 만족 하 ㅂ니다	<P>
싸 다고 사 았 다가 기분 영	<N>
가격 대비 만족 하 아요	<P>
자주 바꾸 는 물건 도 아니 ㄴ 데 짜증 나 더군요	<N>
좋 아요	<P>
구매 하 시 ㄹ 때 잘 고려 하 아 보 시 고 사 시 어요	<N>
나중 에 알 았 지만 친절 하 게 설치 해주 신 기사 님 도 좋 았 습니다	<P>
기존 사 세탁기 가 굉음 을 내 며 고장 나 아서 장모님댁에 놓 아 드리 었 어요	<N>
빨래 를 한번 해보 았 는데 I챦은것같구요	<P>
저 는 밀린빨래땜에 빨리 오 ㄹ 줄 아랏 는 데 거의일걸렷구요	<N>
가격 대비 맘 에 들 어요	<P>
기존 에 트롬만 쓰 다가 새로 살 ㄹ 일 이 생기 어서 저렴 하 ㄴ 가격 에 혹 하 아 사 아 보 았 는데 좋 은 물건 싸 게 잘 산 것 같 네요	<N>
배 란 다 가 좁 아서 사이즈 맞추 는 라 선택 하 았 는데 성능 배송 가격 만족 이 에요	<P>
다만 배송이 조금 오래 걸리 네 요	<N>
가격 대비 매우 만족 스럽 네 요	<P>
문의 하 ㄹ 수 있 는 연락처 이 라도 있 었 으면 좋 을 것 같 습니다	<N>
대우 이 라 그러 ㄴ지 소음 은 다소 있 는 편 이 지만 구색 도 나 고 가격 도 쌓 ㄴ 편 이 구 좋 네요	<P>
근데 배송 은 약간 느리 었 어요	<N>
가격 대비 매우 만족 하 ㅂ니다	<P>
깔끔 하 구 조 아 여	<N>
혼자 사 는데 크 고 좋 은 것 ㄴ 필요 없 어서 일단 저렴 하 ㄴ걸 로 구입 하 았 는데 일단 매우 만족 하 ㅂ니다	<P>
근데 약 간 작 은 느낌 이 네 여	<N>
가격 대비 매우 만족 이 ㅂ니다	<P>
암튼 잘 쓰 ㄹ 것 이 여	<N>
가격 대비 빠르 ㄴ 배송 하구 깔끔 하 ㄴ 디 자 이 ㄴ 맘 에 쏙 들 네 여	<P>
의문 은 물 받 을 때 소음 이 있 는데 원래 그렇 ㄴ 것 이 ㄴ지 잘 모르 겠 네요	<N>
가격 대비 상품 성 이 있 습니다	<P>
깨끗 하 게 빨래 하 ㄹ 수 있 어 좋구서비스 좋 았 습니다	<N>
빠르 ㄴ 배송 도 감사 하 ㅂ니다	<P>
설치 는 친절 하 게 잘 하 아 주 시 었 구요	<N>
가격 대비 상품 은 괜찬네요	<P>
대우 가 제품 뿐 만 아니 라 서비스 에 도 더 신경 을 쓰 어야 삼성 이나 엘지 못하 지 않 을 거 이 란 생각 이 들 ㅂ니다	<N>
가격 대비 서비스 와 상품 질 이 좋 아요	<P>
아주 오래 걸리 니깐 세탁기 를 사실 때 최소 정도 는 여유 있 게 주문 하 시 어요	<N>
약간 은 늦 었 지만 그래도 생각 보다 는 완전 늦 을 거 이 라고 생각 하 았 기 때문 에 빨리 오 아서 만족 하 아요	<P>
지금 세탁기 가 고장 이 났다던가 꼭 필요 에 의하 아 살 시 는 분 이 라면 다른 곳 에서 주문 하 시 라고 말씀 드리 고 싶 네 요	<N>
상품 은 완전 이쁘 네요	<P>
저 같 은 경우 일정 도 걸리 었 습니다	<N>
반신반의 하 면서 주문 하 았 는데 좋 지 않 은 평 이 많 아서 그래도 나름 만족 하 아요	<P>
난감 하 ㄴ 제품 이 이 었 습니다	<N>
가격 대비 성능 굿 이 구요	<P>
날 도 덥 ㄴ데 층 까지 가지 고 오 시 어서 설치 까지 깨끗이 하 아 주 시 고 기존 고 장난 세탁기 도 가져가 아 주 시 고 넘 고맙 습니다	<N>
배송 오 시 ㄴ 기사 님 두 설치 에서 수거 까지 정말 친절 하 시 네요	<P>
근데 화질 이 저금 떨어지 는 듯	<N>
가격 대비 성능 만족 하 ㅂ니다	<P>
이 가격 에 그 정두면 잘샀정	<N>
현재 기능 이나 성능 에서 만족 하 ㅂ니다	<P>
냉장고 와 세탁기 청소기 를 한꺼번에 구매 하 는지라 주말 에 한꺼번에 받 을 수 있 는지 롯데닷컴 에 문의 드리 ㄹ려구 전화 하 았 는 데 여 직원 이 너무나 불 친절 하 네 여	<N>
빠르 ㄴ 배송 이나 구 제품 회수 도 고맙 았 습니다	<P>
그렇 게 불 친절 하 ㄹ 꺼 이 면 왜 서비스직 에 있 나 여	<N>
구매 후 사용 불편 함 을 재 묻 는 콜 센터 의 확인 전화 도 감사 하 았 습니다	<P>
기분 좋 게 상품 사 놓 고 기분 이 완전 나쁘 네 여	<N>
가격 대비 성능 우수	<P>
롯데닷컴 은 직원 들 교육 좀 똑바로 해 주세 이 어	<N>
숙모 가 참 좋아하 시 네요	<P>
너무 고급 스럽 고 만족 하 ㅂ니다	<N>
하숙방 화장실 에 놓 으니 금상첨화	<P>
근데 정말 아주 심하 게 소리 가 크 게 들리 ㅂ니다	<N>
강추합니다	<P>
아무뜬 너무 신나 서 빨 은 이불 은 한 트럭 또 빨 았 다는	<N>
배송도 이삿날 딱 맞추 어 주 시 어서 사다리 차 로 손쉽 게 옴 기고 친 철 하 게 설치 까지 하 아 주 시 고 가시 었 네요	<P>
너무 늦 게 배송 되 어서 좀 애 가 타 았 습니다	<N>
너무 친절 하 시 ㄴ 아저씨 감사 하 ㅂ니다	<P>
전화 도 잘 안 되 구요	<N>
가격 대비 성능 좋 고 디자인 편의 성 다 마음 에 들 네 요	<P>
이 이 라도 크기 는 그렇 게 크 어 보이 지는 않 네 요	<N>
가격 대비 성능 좋 습니다	<P>
하지 만 배 송이 너무 늦 어서 그것 이 좀	<N>
버튼 이 단순 하 아서 나이드신 분 도 사용 하 시 기에 편리 하 ㄴ 거 같 구요	<P>
너무 늦 게 입 고 되 어서 극정했슴니다	<N>
배송지 를 잘못 기록 하 아서 하루 늦 게 받 게 되 었 는데 그러 ㅁ 에 도 불구 하 고 빨리 배송 하 아 주 려고 노력 하 아 주 시 어서 감사 하 ㅂ니다	<P>
잘받았슴니다	<N>
가격 대비 성능 좋 습니다	<P>
너무 많이 기다리 었 고	<N>
디자인 도 깔끔 하 고	<P>
일욜 에 배송 이 되 었 지만 그래도 맘 에 들 ㅂ니다	<N>
가격 대비 성능 좋 아요	<P>
그런데 생각 보다 너무너무 크 어 서 요	<N>
가격 대비 성능 좋 아요	<P>
생각 보다 너무 크 ㅂ니다	<N>
가격 대비 성능 짱 이 ㅂ니다	<P>
너무늦어짜증났으나	<N>
가격 대비 성능 참 좋 습니다	<P>
물건을받으니맘에들어요	<N>
가격 대비 성능 디자인 가격 다 만족 하 아요	<P>
넘 만족 이 에요	<N>
가격 대비 성능완전좋고 특히 기사 님 이 너무좋으세요	<P>
년도 월 세 제품 잘 받 았 습니다	<N>
엘레베이터없는층인데도 너무 밝 은 모습 으로 배달 해 주시 고 설치 까지 깨끗 하 게 하 아 주 시 고 정말 좋 습니다	<P>
아직 은 안 쓰 어 보 았 지만 조금 은 약하 ㄴ 듯 하 ㄴ 느낌 이 들 네 요	<N>
가격 대비 성능 은 I찮은것 같 네요	<P>
키로 짜리 치고 는 좀 작 은 거 같 은 데 요	<N>
주문 후 배송 이 빠르 아 좋 았 고 그럭저럭 사용 하 기 에 는 좋 습니다	<P>
원래 작 은 것 ㄹ 사 려다가 이것 산거 이 라 그것 ㄴ 괜찮 구요	<N>
대체 적 으로 만족	<P>
다 좋 은데 배송 이 너무 느리 어 요	<N>
가격 대비 성능 은 괜찮 습니다	<P>
대우전자 제품 이 라서 구입 하 았 는데 다 좋 은데 배송 이 너무 느리 어 요	<N>
가격 대비 성능 은 최상 이 듯	<P>
다 좋 은데 배송이 느리 ㄴ 것 이 좀 그러 네 요	<N>
회사 에서 사용 하 ㄹ 꺼 이 라 싼걸 찾 아 사 았 는데 막상 돌리 어 보 니 빨래 도 잘 되 고 소음 도 작 고 좋 네요	<P>
피 존 사용 시 불편 하 ㄹ 듯	<N>
배송 기사 님 도 친절 하 시 고 제품 행여나 상 하 ㄹ까 보 아 조심조심 옮기 어 주 시 고 아무쪼록 번창 하 시 어요	<P>
다 좋 은 데 이 요	<N>
가격 대비 성능 이 좋 아요	<P>
어머니 가 그러 시 는데 같 은 대 에 비하 아 통 이 좀 작 대 요	<N>
가격 대비 성능 이 며 디자인 이 며 너무 좋 아요	<P>
걔 서 무 통장 입금 을 하 아 드리 었 는데 어찌나 늦 확인 이 되 는지 은행 에 전화 까지 하 았었 답니다	<N>
배송 도 확실 하 구	<P>
돈 은 빠져나가 았 는데 지 마켓 에 ㄴ 입금 내역 이 없 다니	<N>
무엇 보다 도 처리 하 기 힘들 었 던 그전 세탁기 를 수거 하 아 가 아 주 시 어서 너무 감사 드리 ㅂ니다	<P>
저녁 시가 넘 어 확인 하 아 보 니 그제서야 대략 시간 정도 확인 이 안되 더라구요	<N>
가격 대비 성능짱	<P>
어찌나 당황 스럽 던지	<N>
가격 대비 세탁끝내줍니다	<P>
지 마켓 이 상당히 바쁘 아 지 ㄴ 모양 이 ㅂ니다	<N>
배송도 빠르 고요	<P>
다른 건 모르 겠 고 주문 하 ㄴ지 말 ㄴ 주 만 에 배송 되 ㄴ 것 은 좀 문제 가 많 지 않 나 요	<N>
써비스 대 만족 이 ㅂ니다	<P>
인터파크 제조 업체 배송 업체 어느 곳 의 책임 이 지 모르 겠 지만 시스템 상 의 문제 가 있 는 것 같 습니다	<N>
가격 대비 세탁물 용량 도 크 고 디자인 도 깔끔 하 고 모던 하 면서 좋 네요	<P>
다른 것 보다 배송 이 빠르 아서 좋 습니다	<N>
좋 은 상품 감사 하 ㅂ니다	<P>
다른 동일 용량 에 비하 아 크기 가 작 습니다	<N>
가격 대비 아주 만족 이 ㅂ니다	<P>
그치 만 그리 크 ㄴ 편 은 아니 구요	<N>
가격 대비 아주 만족 하 ㅂ니다	<P>
다른 분 들 의 상품 평 과 는 달리 소음 이 조금 있 는 편 이 ㅂ니다	<N>
가격 대비 아주 만족 하 ㅂ니다	<P>
의 용량 이 지만 실제로 조금 작 은 것 같 습니다	<N>
같 은 상품 의 가격 보다 훨씬 싸 게 구입 하 게 되 어 무엇 보다 기쁘 ㅂ니다	<P>
과거 에 쓰 던 삼성 의 용량 의 세탁기 보다 작 은 것 같 아요	<N>
가격 대비 아주 좋 습니다	<P>
세탁 을 처음 시작 하 ㄹ 때 세탁 시간 은 조절 불 가능 하 ㅂ니다	<N>
가격 이 저번 에 살 때 보다 원 오르 ㄴ 가격 이 지만 그래도 가장 저렴 하 고 싸이즈 도 아 담 하 고 아 주 좋 습니다	<P>
다른 상품 평 과 마찬가지 로 소음 이 심하 다는 점	<N>
가격 대비 아주 좋 읍니다	<P>
그것 이 단점 이 기 ㄴ 하 지만 나머지 성능 은 다른 브랜드 와 비교 하 아서 꿀리 ㄹ 것 이 없 는 것 같 습니다	<N>
가격 대비 용량 크 고요	<P>
다른 싸이트들에도 들어가 아 보 았 지만 지금 이 가격 에 이 제품 이 가장 저 렴 하 더군요	<N>
세탁 굿 이 에요	<P>
다른 면 은 다 좋 은데 다른 세탁기 에 비 해서 소 음 이 조금 있 어요	<N>
디자인 도 깔끔 하 고요	<P>
다른 분 부탁 으로 시키 어 드리 었 는데 괜찮 으시 데 요	<N>
무엇 보다 배송 최고 이 었 어요	<P>
다른 분 들 과 마찬가지 로 배송 이 좀 문제 길 ㄴ 하 었 죠	<N>
기사 아저씨 감사 해 용	<P>
월 일 에 구입 하 아서 월 일 에 받 았 으니까요	<N>
가격 대비 잘 산거 같 습니다	<P>
그래도 깨끗 하 게 잘 빨리 고 좋 네요	<N>
가격 대비 적극 추천 일 이 ㅂ니다	<P>
소음 도 장난 아니 구요	<N>
대우 기사 분 도 친절 하 시 고 배송 빠르 기 도 빠르 고 중요 하 ㄴ 제품 도 만족 하 ㅂ니다	<P>
그래도 싸 ㄴ 가격 에 잘 산거 같 아요	<N>
가격 대비 정말 괜찮 은 상품 이 네요	<P>
소음 이 심하 다고 하 고 배송 이 언제 되 냐고 하 시 고	<N>
드럼 세탁 기 좋 아요	<P>
그런 걱정 들 마 세 요	<N>
첨 에 ㄴ 걱정 하 았 는데 쓰 어 보 고 무지 하 게 좋 네요	<P>
탈수 시 에 약간 의 휘파람 소리 조금 나 ㅂ니다	<N>
가격 대비 정말 좋 고 여	<P>
아직 도 배 아 파 요	<N>
가격 대비 정말 좋 습니다	<P>
다양 하 ㄴ 기능 들 이 있 어서 아직 다 사용 하 아 보 지 는 않 았 지만 대체로 만족 하 ㅂ니다	<N>
디쟌 도 좋 구 색상 도 괜찮 구요	<P>
암튼 세탁기 잘 쓰 ㄹ 것 이 요	<N>
배송도 일 만 으로 빠르 ㄴ 편 이 고 배송 기사 님 들 도 아주 친절 하 시 었 답니다	<P>
처음 에 ㄴ 일 만 에 전화 가 오 길래 생각 보다 빠르 구나 하 었 더니 약속 하 ㄴ 날 에 오 지 도 않 고 발신 번호 확인 하 아서 전화 하 았 더니 없 는 번호 이 라고 나오 구	<N>
이용 후기 보 고 사 았 는데 탁월 하 ㄴ 선택 이 었 습니다	<P>
배송만 빼 면 뭐 하나 불만 이 랄 것 이 없 는 제품 이 ㅂ니다	<N>
가격 대비 정말 좋 은 좋 건 이 구 이 어	<P>
대용량 이 ㄴ데 도 깜찍 하 ㄴ 크기 에 이 가격 이 면 정말 좋 네요	<N>
배송 때 에 도 정말 친절 하 게 하 아 주 시 어서 감사 해 여	<P>
동력 이 약하 아요	<N>
가격 대비 제품 도 좋 고요	<P>
크 ㄴ 빨래 힘들 구요	<N>
배송일 에 맞추 어 주 어서 고맙 네요	<P>
물 이 수직 으로 떨어지 지 않 아 물 이 세탁기 밖 으로 다 튀 어 요	<N>
배송 기사 가 만족 스럽 게 하 아 주 어서 좋 았 어요	<P>
싼맛 에 구입 하 았 는데 가격 이 더 떨어지 니 더 속 상하 네 요	<N>
가격 대비 조용 하 고 잘 빨리 는 국산 세탁기 네 요	<P>
반품 하 려다 일 기다리 어서 오 았 는데 빨래 밀릴까봐 그냥씁니다	<N>
가격 대비 좋 습니다	<P>
잘 아 쓰 고 있 습니다	<N>
가격 대비 좋 습니다	<P>
만족	<N>
디자인 좋 구요	<P>
세탁기 기능 도 깔끔 하 게 간편 하 게 되 어 있 어 사용 이 편리 하 구요	<N>
가격 대비 좋 습니다	<P>
대우일렉 설치 기사 님 들 께서 직접 배송 에 설치 사용 방법 까지 상세히 설명 해 주시 고유 의사 항 도 챙기 어 주 시 는 센스	<N>
혼자 쓰기 에 딱 좋 아요	<P>
다만 주문 에서 배송 까지 일주일 이 걸리 었 다는 거	<N>
가격 대비 좋 습니다	<P>
암튼 어제 써봤는데만족스럽습니다	<N>
가격 대비 좋 습니다	<P>
배송 이 너무 느리 어 요	<N>
가격 대비 좋 아요	<P>
대우전자 담당자 가 직접 배송 하 아 주 고 설치 에 테스트 까지 다 하 아 주 고 사용 설명 까지 자세히 하 아 주 니 만족 스럽 네 요	<N>
가격 대비 좋 았 고 요	<P>
다만 생각 보다 트롬 세탁기 는 무척 작 네요	<N>
세탁기 도 마음 에 들 었 습니다	<P>
거기 다 소음 이 좀 나 구요	<N>
가격 대비 좋 은 것 같 네요	<P>
그 것 은 아래 다른 상품 평 에서 도 있 어서 그렇 ㄴ가 하 고 넘기 는데 좀 타 는 듯 하 ㄴ 냄새 가 나 거든요	<N>
가격 대비 좋 은 제품 감사 하 ㅂ니다	<P>
과열 되 어서 그러 는 것 같 은데 그냥 두 어도 괜찮 은 건지 요	<N>
가격 대비 좋 은 것 같 아요	<P>
세탁기 가 빨래 가 다되 고 나서 어 꺼지 ㄴ지 한참 되 면 냄새 는 서서히 없 어 지 기 는 하 는데 걱정 이 되 ㅂ니다	<N>
아직 사용 전 이 지만 괜찮 아요	<P>
참 그런데 설치 하 아 주 시 고 가시 는 기사 님 들 두 분 이 친절 하 시 ㄴ 편 이 시 어요	<N>
가격 대비 좋 은 데 여	<P>
부탁 드리 ㄹ게 여	<N>
가격 대비 좋 은 상품 이 네요	<P>
도대체 언제 오 는 겨	<N>
가격 대비 짱	<P>
배송 완료 이 라고 뜨 어 있 는데 연락 조차 없 으니 기다리 다 목빠지긋넹	<N>
가격 대비 참 괜찮 은 제품 이 라고 하 시 네요	<P>
도저히 참 을 수 없 을 정도 로 소비자 을 우롱 하 는 업체	<N>
가격 대비 최고 네 요	<P>
일 날 에 ㄴ 재고 가 있 었 는데 지금 없 다며	<N>
모터 소리 조금 크 기 ㄴ 하 지만 가격 대비 최곱니다	<P>
소비자 가지 구 장난 하 는 것 두 아니 구 날짜 확정 두 못 주 다며	<N>
가격 대비 최고 이 구요	<P>
소비자 가 완전 밥 이 듯	<N>
추석 연휴 전 이 ㄴ데 도 빠르 ㄴ 배송 과 친절 하 ㄴ 설명 설치 도 잘해주시고너무 맘 에 들 어요	<P>
너무 어이없 는 업체 이 ㅂ니다	<N>
가격 대비 성능 정말 좋 아요	<P>
인터파크 에 전화 하 아 보 니 역시 판매자 가 재고 가 없 어 몇일 걸리 ㄴ다는 말 뿐	<N>
가격 대비 최고 이 ㅂ니다	<P>
기다리 라는 말 뿐 이 더 라 구 이 어	<N>
가격 대비 최고 이 ㅂ니다	<P>
월 일 날 주문 하 아 월일 날 받 았 습니다	<N>
암튼 이 가격 에 이만한 드럼 세탁 기 는 없 다고 생각 하 ㅂ니다	<P>
정말 인터넷 쇼핑 몇 년 째 하 었 지만 이렇 게 소비자 우롱 하 는 업체 처음 보 ㅂ니다	<N>
설치 하 아 주 시 는 기사 분 도 너무 친절 하 시 네요	<P>
가격 두 다르 ㄴ데 보다 쌓 ㄴ 것 두 아니 구 급하 아서 조금 더 비싸 게 주 구 주문 하 았 더니만	<N>
암튼 좋 은 제품 많이 많이 파 시 어요	<P>
완죤 사람 돌 아 버리 게 하 는 이 런 업체 다 신 저 같 은 소비자 가 없 기 ㄹ 바라 는 맘 에 이렇 게 글 올리 ㅂ니다	<N>
가격 대비 최고 이 ㅂ니다	<P>
드럼 세탁 기 는 다른하우젠이나 다른 드럼 세탁 기 세탁 기 비하 아 무지 소음 이 심 하 ㅂ니다	<N>
배송 하 아 주신 기사 님 도 매우 친절 하 시 었 구요	<P>
탈수 하 ㄹ 때 쇠 소리 가 무지 크 ㅂ니다	<N>
좋 은 상품 구매 하 도록 하 아 주 시 ㄴ 디엔乍?감사드려요	<P>
탈수 하 ㄹ 때 흔들리 어서 결국 수평 조절 다시 하 었 어요	<N>
가격 대비 최선 의 선택	<P>
두껍 ㄴ 이불 빨래 는 안 되 지만 세탁기 깔금하고 괜찮 네요	<N>
가격 대비 크기 성능 디자인 모두 마음 에 들 ㅂ니다	<P>
다만 소음 은 아무래도 저가 모델 이 니 고장 이 아닌가 싶 은 불안 하 ㄴ 소리 도 나 고	<N>
가격 대비 품질 짱	<P>
탈수 시 에 나 는 항공기 소 음 은 좀 많이 놀라 았 지만 정상작 동 하 는데다가	<N>
깔끔 하 ㄴ 외부 기능 도 킹왕짱	<P>
인버터 도 아니 고 저렴 하 ㄴ 가격 을 생각 하 아 보 면 뭐 괜찮 습니다	<N>
가격 대비 품질 도 좋 구요	<P>
드럼 세탁기 도 사용 하 아 보 았 는데 성격 급 하 ㄴ 저 로서 는 일 반 세탁기 가 더 편하 고 좋 은 거 같 아요	<N>
하여튼 좋 은 물건 을 쌓 ㄴ 가격 에 살 수 있 는 시장 이 온라인 시장 이 라 구매자 입장 에서 ㄴ 상당히 좋 네요	<P>
드럼 세탁 기 가격 대비 넘 좋 네요	<N>
가격 대비 품질 은 좋 은 거 같 습니다	<P>
삶 음 빨래 도 잘 되 고 성능 은 그럭저럭 좋 은 거 같 습니다	<N>
주말 에 만 받 을 수 있 어서 주말 에 배송 하 아 달 라고 요청 하 았 는데 그렇 게 하 아 주 시 어서 감사 하 ㅂ니다	<P>
생각 보다 많 은 빨래 를 못하 ㅂ니다	<N>
가격 대비 훌륭 하 ㄴ 서비스 를 보이 어 주 시 ㄴ 기사 님 들 께 감사 드리 어요	<P>
그전 에 트롬 하 기 로 짜리 쓰 었 는데 용량 은 이것 이 더 작 은 것 같 습니다	<N>
제품 도 아직 은 수준급 이 고요	<P>
결론 적 으로 말씀 드리 자면 물방울 이 중앙 으로 오 면 수평 인 줄 알 수 이 었 다던가 통안 이 다이아몬드 모양 이 라 세척력 이 더 좋 은 것 같 고 끝나 고 나 면 음악 소리 가 나오 는 점 이 좋 고요	<N>
쓰 어 보 고 대우 를 많이 사랑할랍니다	<P>
뚜껑 이 좀 가볍 ㄴ 것 과 이 라고 생각 하 기 에 ㄴ 통 이 좀 작 은 것 같 다는 점 그리 고 헹구 ㅁ 과 탈수 횟수 의 선택 이 가시 적 으로 몇 번 이 지 표시 되 지 않 는다는 점 이 제 맘 에 ㄴ 별루 안 들 는 점 이 ㅂ니다	<N>
가격 대비 좋 은 거 같 아요	<P>
너무 물살 과 통 이 살살 돌아가 아요	<N>
가격 대비 직원 분 들 도 친 철 하 고 좋 네요	<P>
때불림 기능 이 있 어서 이 지 돌아가 다 잠깐 씩 멈추 기 도 하 구	<N>
배송 빠르 고 굳	<P>
같이 주문 하 ㄴ 위니아 에어컨 은 아직 연락 도 없 고 감 감	<N>
가격 대비 굿	<P>
드럼 세탁 기만 쓰 었 는데 무지 불만 이 었 어요	<N>
너무 좋 아요	<P>
빠르 아도 빨 ㄴ 것 같 지 도 않 고	<N>
가격 대비 만족 하 ㅂ니다	<P>
그런데 역시 통 돌 이 가 좋 아요	<N>
세탁기성능은아직써보지않아서모르겠지만배송도빠르네요	<P>
그리고 거름망 도 편리 하 게 되 어 있 어서 맘 에 들 ㅂ니다	<N>
가격 대비 아 주 만족 하 ㅂ니다	<P>
그래서 전 에 쓰 던 것 처럼 무난 하 게 통 돌 이 사 아 드리 었 는 데 무 척 이나 마음 에 들 어 하 시 네요	<N>
서비스 기사 님 도 아주 친절 하 시 어서 이웃 에게 적극 추천 하 아 주 고 싶슴니다	<P>
드럼 쓰 다가 찜찜 하 아서 바꾸 었 는데 시원 하 게 세탁 잘 되 어서 넘 좋 습니다	<N>
가격 대비 에 비하 아 좋 은 물건 빠르 ㄴ 배송 감사 하 ㅂ니다	<P>
특히 성능 문제 는 대우 만 하 ㄴ 것 이 없 더군요	<N>
가격 대비 외 향 기능 만족 이 ㅂ니다	<P>
디자인 색상 모두 마음 에 들 네 요	<N>
가격 대비 하 아서 넘 좋 구요	<P>
그런데 배송 이 너무 느리 어서 세탁비 가 더 들 어 가 ㄴ 거 같 네요	<N>
색상 도 이쁘고여튼 넘 만족 이 ㅂ니다	<P>
디자인 품질 아주 좋 아요	<N>
많이 팔 시 고 행복 하 시 어요	<P>
배송기 간 이 너무 길 었 던 것 이 흠 이 네요	<N>
가격 대비 하 아서 우수 하 ㄴ 제품 이 ㄴ 것 같 고 기사 분 들 이 친절 하 아서 좋 았 습니다	<P>
디자인 디자인 은 깔끔 하 고 세탁기 색 이 흰색 이 라 더욱 세련 되 어 보이 ㅂ니다	<N>
가격 도 가격 이 지만 디자인 도 깨끗 하 니 좋 네요	<P>
가격 에 비하 아 만족 하 ㅂ니다	<N>
가격 도 괜찮 구 빨래 도 잘 되 고 페세탁기도 수거 하 아 가시 구 여러모로 만족 하 ㅂ니다	<P>
디자인 도 괜찮 고 조용 하 게 깨끗 하 게 잘 되 네 요	<N>
가격 도 괜찮 은 것 같 고 성능 도 괜찮 은 것 같 아요	<P>
디자인 도 깔끔 하 고 때 도 잘 아 빠지 구 저렴 하 ㄴ 가격 에 잘 나오 ㄴ 것 같 습니다	<N>
저희 오빠 집 에 도 이 세탁기 쓰 는데 좋 아요	<P>
다만 탈수 기능 은 성능 이 좀 떨어지 는 듯	<N>
세탁 해보 았 는데 잘 되 ㅁ	<P>
그래도 이 정도 면 괜찮 은 것 같 네요	<N>
가격 도 너무 저렴 하 게 구입 하 고 성능 도 좋습니당	<P>
다만 흠 이 라면 다른 분 들 의견 처럼 소음 이 조금 크 ㄴ 것 같 아요	<N>
가격 도 너무 좋 고 디자인 도 너무 괜찮 아요	<P>
배송 문제 는 물론 좋 았 구요	<N>
깨끗 하 고 세탁 도 당근 잘 되 고 너무너무 만족 이 ㅂ니다	<P>
다만 흠 이 라면 다른 분 들 의견 처럼 소음 이 조금 크 ㄴ 것 같 아요	<N>
그리 고 배송 하 아 주 시 었 던 분 도 친절 하 시 고 완전 굳이 예 요	<P>
배송 문제 는 물론 좋 았 구요	<N>
좋아좋아좋앙	<P>
디자인 도 별로 이 고	<N>
가격 도 넘 저렴 하 고 성능 도 좋 습니다	<P>
크기 도 전 에 있 던 것 보다 작네용	<N>
외부 는 컴팩트 하 지만 내부 는 넓 고 디자인 도 심플 하 고 드럼 세탁 기 안부러워요	<P>
어?든 잘 쓸꼐요	<N>
이전 에 쓰 던 대우공기방울키로짜리 사용 하 았었 는데 고장 이 나 는 바람 에 이것 ㄹ 급히 구입 하 았 는데 잘 산 것 같 네요	<P>
디자인 도 예쁘 고 성능 도 괜찮 은 거 같 은데 탈수 하 ㄹ 때 소음 이 넘 크 ㄴ 거 같 아요	<N>
새롭 ㄴ 세탁기 가 빨래 를 하 아 주 었 는데 얼마나 고맙 던지	<P>
첨 에 ㄴ 어느 집 공사 하 는 줄 알 았 을 정도	<N>
그리고 얼마나 예쁘 어 보 았 는지	<P>
예쁘 ㄴ 디	<N>
강추입니다	<P>
다만 배송 이 너무 늦 어서 기다리 느라 기린 목 이 되 ㄹ 뻔 하 었 어요	<N>
가격 도 다른 곳 보다 저렴 하 고 품질 도 듣 던 데 로 좋 습니다	<P>
배송이 늦 을 경우 일주일 쯤 지나 면 문자 이 라도 주 면 언제 쯤 올 지 알 고 기다리 ㄴ다면 덜 지루 하 ㄹ 뻔 하 었 어요	<N>
가격 도 만족 하 고 설치 하 시 는 서비스 도 만족 하 ㅂ니다	<P>
암튼 잘 사용 하 ㄹ 것 이 요	<N>
가격 도 맘 에 들 ㄹ 구 이 어	<P>
분 이상 탈수 동작 만 하 면 전기세 장난 아니 ㄹ 것 같 아요	<N>
성능 도 좋 아요	<P>
디자인 도 좋 고 무엇 보다 꼭 필요 하 ㄴ 기능 이 잘 갖추 어 지 ㄴ 것 같 아서 고장 도 없 을 것 같 고 암튼 좋 습니다	<N>
가격 도 싸 고 기능 이 많 고 사용 하 기 가 편하 아서 좋 아요	<P>
저가 상품 이 라 건조 는 안 되 지만 건조대 사면 되 는 거 아닌가요	<N>
가격 도 싸 고 괜찮 은 것 같 네요	<P>
소음 이 좀	<N>
가격 도 싸 고 괜찮 은 것 같 네요	<P>
디자인 은 투박 하 지만 잘 돌아가 고 잘 빨리 네 요	<N>
서비스 기사 님 들 도 친절 하 고 수고 많 았 습니다	<P>
일 날 결제 하 고 어제 받 았 거든 요	<N>
가격 도 싸 고 모양 도 예쁘 고 너무너무 좋 아요	<P>
하지 만 배 송 에 문제 가 있 더군요	<N>
늦 게 도착 하 ㄹ 줄 알 았 는데 배송 또한 너무 빠르 네요	<P>
죄송 하 다는 말 과 함 께 주 문 생산 이 라서 늦 을 거 이 라 이 더군요	<N>
가격 도 싸 고 배송 기사 분 도 친절 하 시 어요	<P>
그간 일간 빨래 는 밀리 어 있 었 고 밀리 ㄴ 빨래 다 하 느라 죽 는지 알 았 습니다	<N>
배송이 약간 느리 ㄴ 것 빼 고는 싼값 에 너무 잘 살 ㄴ 것 같 아요	<P>
디자인 좋 고 색상 좋 고 배송 도 빠르 고 다 만족 하 는데요	<N>
아직 빨래 는 해보 지 않 았 지만 겉모양 만 보고 도 만족스럽구요	<P>
가끔 세제 덩어리 가 조금 씩 나오 는 것 같 아요	<N>
사용법 이 간단 하 아서 좋 습니다	<P>
세제 가 안 좋 아서 안 풀리 ㄴ 것 이 ㄴ지	<N>
가격 도 싸 고 배송 빠르 고 좋 네요	<P>
디자인 좋 고 가격 저 렴 하 고 크기 가 생각 하 았 던 거 보다 작 아서 그렇 지 모든 것 이 좋 네요	<N>
설치 기사 분 이 잘 하 아 주 시 어서 더 좋 습니다	<P>
그런데 생각 보다 소리 가 크 ㄴ 듯	<N>
가격 도 싸 고 성능 도 좋 습니다	<P>
세탁력 도 그다지	<N>
가격 도 싸 고 아주 좋 습니다	<P>
디지털 하 면 역시 삼성 이 지 않 아요	<N>
배송도 딱 그 날짜 에 맞히 어 주 시 고 너무 좋 네요	<P>
근데 이 불 빨 기 에 ㄴ 좀 작 은 듯	<N>
이 가격 에 드럼 세탁 기 정말 좋 습니다	<P>
때 가 안 빠지 어요	<N>
가격 도 싸 고 아주 좋 습니다	<P>
뚜껑 이 투명 하 아 안 에 내용물 도 보이 고 색상 도 깔끔 하 고 좋 네요	<N>
배송도 딱 그 날짜 에 맞히 어 주 시 고 너무 좋 네요	<P>
그런데 용량 이 생각 보다 적 은 거 같 아요	<N>
이 가격 에 드럼 세탁 기 정말 좋 습니다	<P>
뜨겁 네요	<N>
가격 도 싸 고 원하 는 날짜 에 연락 하 시 고 잘 가 았 다 주 시 네요	<P>
조심 하 아야 하 겠 어요	<N>
싸 게 잘 살 ㄴ 거 같 아 기분 이 좋 네요	<P>
뜻밖 의 기회 에 잡 은 세탁기 를 잡 은 것 같 아요	<N>
좋 아요	<P>
그래도 막상 세탁 실 에 빙글빙글 돌 고 있 는 빨래 를 보 니 기분 이 흐뭇	<N>
년 도 넘 은 거 이 라 그러 ㄴ지 덜덜거리 지 않 고 좋 아요	<P>
소음 문제 는 세탁 중 에 는 빌트 인 처럼 조용 하 ㄴ데 탈 수시 에 는 비행기 이착륙 하 ㄹ 때 의 터 보 엔진 같 은 소리 가	<N>
배송도 빠르 고	<P>
소리 가 그렇 게 까지 크 지 않 지만 조용히 돌아가 다가 그런 소리 가 나니 상대 적 으로 크 고 귀 에 거슬리 는 듯	<N>
가격 도 싸 고 품질 도 괜찮 네요	<P>
하지만 다른 분 들 얘기 처럼 가격 대비 제품 디자인 이나 크기 만족 하 ㅂ니다	<N>
아주 좋 아요	<P>
어쨌든 만족 하 ㅂ니다	<N>
적극 추천 하 ㅂ니다	<P>
많 은 글 을 읽 어 보 았 는데 소음 이 심하 다는 말 이 많 더군요	<N>
가격 도 싸 고 품질 도 좋 고 디자인 도 깔끔 하 고 배송도 하루 만 에 좋 아요	<P>
많 은 분 들 이 배송 이 느리 다라고 말씀 하 시 어서 여유 를 가지 고 기다리 었 더니 꼬박 열흘 은 걸리 ㄴ 것 같 습니다	<N>
세탁기 돌리 어 보 았 는데 세탁 도 잘 되 네 여	<P>
많이 기다리 어서 받 은 지 이 라 받 자마자 세탁기 돌리 었 는데 말씀 들 대로 소리 가 좀 크 네요	<N>
가격 도 인터파크 가 저 렴 하 고 배 송 도 빠르 았 구요	<P>
그리고 드럼 은 처음 이 라 거품 도 별로 안 나 고 물 도 별로 알 나 오 아서 이것 이 세탁 이 되 는 것 이 ㄴ가 싶 더라구 요	<N>
부담 없이 쓰 기에 좋 은 제 품 이 ㅂ니다	<P>
깨끗이 빨렸다는 느낌 도 별로 없 고 일단 세탁 하 기 전 에 뭐 묻 은 것 ㄴ 미리 좀 지우 고 하 아야 하 ㄹ 듯 싶 네 요	<N>
가격 도 잘 절충 하 아 주 시 었 고 배송 도 원활 하 았 구요	<P>
아무튼 덥 ㄴ데 배송 하 아 주 시 느라 설치 하 아 주 시 ㄴ 기사 님 너무 수고 많 으시 었 어요	<N>
받 아 보 시 ㄴ 저희 부모 님 들 께서 흡족 하 시 었 습니다	<P>
설치 조건두 영 까탈스러웠구나중에 문제 되 ㄴ다는 등	<N>
가격 도 저렴 하 고 거기 에다 품질 배송 에 설치 까지 완벽 하 게 만족 하 ㅂ니다	<P>
다행히 친절히 하 아 주 시 었 지만 도시가스 비 엄청 나오 았 다는	<N>
가격 도 저렴 하 고 그렇 다고 물건 이 하 자 있 는 것 도 아니 고 게다가 배달 하 아 주 시 는 분 이 친절 하 시 어서 참 좋 았 습니다	<P>
세탁 은 잘 되 구 있 지만 배송 문제 랑 설치 기사 님 은 불 친절 하 시 어서	<N>
이런 기 회 가 자주 있 었 으면 좋 겠 네요	<P>
말짱 꽝 이 면 그 회사 보 ㄹ 거 없 는 거 이 죠	<N>
가격 도 저렴 하 고 기사 아저씨 도 친절 하 게 잘 산 것 같 아요	<P>
판매자 가 전화 가 오 아서 사과 전화 하 라고 하 ㄴ다더니 사과 전화 는 안 오 고 며칠 뒤 에 구매 결정 하 아 달 란 전화 만	<N>
가격 도 저렴 하 고 디자인 깔끔 하 고 배 송 설치 친절 하 게 하 아 주 시 었 어요	<P>
기분 나쁘 아서 알 았 다고 하 고 그냥끊었네요	<N>
가격 도 저렴 하 고 디자인 도 깔끔 하 고 세탁 도 잘 되 고 일석삼조 네 요	<P>
라 는 크 ㄴ 회사 가 서비스 가 이렇 어서 야	<N>
요즘 같 은 불경기 시대 에 딱 이 ㄴ 제품 인 것 같 아요	<P>
맘 에 드 신 대 요	<N>
배송도 빠르 고 생각 보다 빠르 고 배송 하 아 주 시 는 분 도 무척 친절 하 시 었 어요	<P>
일 하 아야 대 는데 이것 자 채우기 넘 힘들 ㄹ 당	<N>
가격 도 저렴 하 고 디자인 도 이 정도 면 굿	<P>
하지만 배송 끝내 주 게 늦 더라구 요	<N>
이불 빨래 도 하 ㄹ 수 있 을 만큼 큼직 하 아서 좋 아요	<P>
우리집 에 똑같 은 키로 짜리 가 있 는데 크기 차이 가 쩜 나 요	<N>
모두 에게 강추	<P>
먼저 최악 은 다르 ㅁ 아니 ㄴ 배송	<N>
가격 도 저렴 하 고 물건 은 좋 은 거 같 아요	<P>
무려 일 만 에 받 았 음	<N>
자취 하 아서 중고 를 살 ㄹ까 하 았 는데 중고 가격 도 그리 쌓 ㄴ 편 은 아니 여 서 인터넷 으로 구입 하 ㄴ 것 이 ㄴ데 괜찮 더라구요	<P>
이것 ㄴ 정말 아니 ㄴ 듯	<N>
가격 도 저렴 하 고 배송도 빠르 ㄴ 편 이 면서 배송 하 시 는 직원 분 들 도 굉장히 친절 하 고 설명 도 잘 하 아 주 시 었 습니다	<P>
물건 을 확보 하 고 판매 하 아야 하 는데 마치 돈 부터 먼저 받 고 물품 제작 하 아서 팔 는 듯 하 ㄴ 느낌	<N>
디자인 도 이쁘 면서 사용 하 기 도 아주 편리 하 ㅂ니다	<P>
이 하나 로 인터파크 도 크 ㄴ 욕 을 먹 을 것 으로 봄	<N>
가격 도 저렴 하 고 배송 도 빠르 아 좋 았 습니다	<P>
아무리 주문 이 갑자기 폭주 하 았 다 도 많이 씁쓸	<N>
가격 도 저렴 하 고 배송 도 좋 고 친절 하 아요	<P>
근데 좀 시끄럽 다는 거	<N>
매우 만족 하 ㅂ니다	<P>
모든 면 에서 만족 하 ㅂ니다	<N>
가격 도 저렴 하 고 배송 서비스 도 사전 에 예약 하 ㄴ 것 을 최대한 지키 려는 모습 좋 았 습니다	<P>
모양 도 이쁘 고 탈수 하 ㄹ 때 소음 이 있 다 하 았었 는데 전혀 문제없 어요	<N>
가격 도 저렴 하 고 배송 하 신분 친절 하 시 네요	<P>
기사 님 이 모터 가 돌아가 기 때문 에 어쩌 ㄹ 수 없 다고 하 시 었 는데 처음 에 윙윙소리나는 정도 는 가볍 게 애교 로 들렸는데헹굼과 탈수 에서 는 소리 가 좀 세 네요	<N>
추천 하 ㅂ니다	<P>
세탁 시간 도 좀 길 ㄴ 거 같 구요	<N>
가격 도 저렴 하 고 배송 하 아 주 시 ㄴ 분 들 너무 친절 하 시 어요	<P>
그래도 빨래 잘 되 니까 대체로 만족 하 ㅂ니다	<N>
가격 도 저렴 하 고 사용 방법 도 간단 하 고 좋 네요	<P>
토요일 물건 배송 되 ㄹ까 엄마 는 밖 에 일 있 는데 나가 지 도 못하 고 진짜 짜증 나 았 어요	<N>
그냥 편하 게 사용 하 기에 정말 좋 은 제품 이 ㄴ 거 같 네요	<P>
못 오 면 못온다 전화 한통 이나 주 시 던 지 이 요	<N>
배송 기사 님 도 친절 하 시 고 모든 것 이 만족 하 ㅂ니다	<P>
목요일 날 입금 하 았 는데 토요일 날 설치 하 아서 넘 좋았어용	<N>
앞 으로 도 좋 은 물건 많이 올리 어 주 시 고 대 박 나 시 어요	<P>
데 통 이 작 아요	<N>
가격 도 저렴 하 고 사용 하 아 보 니까 괜찮 은 데 요	<P>
통 이 크 었 음 하 았 는데 크 ㄴ 이불 은 안 들 어 가 ㄹ 것 같 애 요	<N>
가격 도 저렴 하 고 생각 보다 배송 도 빠르 고 깔끔 하 고 이쁘내요	<P>
무 난 하 네 여	<N>
맘 에 들 어요	<P>
단지 단점 이 라면 세탁 거름 망 이 삼성 은 필터 이 ㄴ데 대우 는 망 사망 이 라 불편 여	<N>
가격 도 저렴 하 고 생각 보다 배송 이 빨리 되 었 네요	<P>
무난 하 ㄴ 것 같 네요	<N>
가격 도 저렴 하 고 설치 도 잘 하 아 주 시 었 어요	<P>
무난 하 ㄴ 디자인 에 트롬 세착기를 정말 저렴 하 게 구입 하 ㄹ 수 있 어 좋 았 습니다	<N>
배송도 빠르 고 잘 돌아가 ㅂ니다	<P>
무슨 쓰 어 보 지 도 안 하 고 구매 결정 안 하 ㄴ다고 매일 전화 하 아서 사람 이나 괴롭히 고 무슨 이런 판매자 가 다 있 습니까	<N>
가격 도 저렴 하 고 설치 도 잘 하 아 주 시 었 어요	<P>
정말 짜증 나 는 판매자 이 ㅂ니다	<N>
배송도 빠르 고 잘 돌아가 ㅂ니다	<P>
이제 세탁기 하나 살 ㄴ걸 전 식구 가 다 알 겠 네요	<N>
가격 도 저렴 하 고 성능 도 갠찮고 갠찮네요	<P>
무엇 보다 가격 이 쌓 ㄴ 것 이 좋 습니다	<N>
가격 도 저렴 하 고 성능 도 굿	<P>
같 은 날 김치 냉장고 딤채 배송 직원 은 왕 쌀 쌀 왕재수	<N>
가격 도 저렴 하 고 성능 도 아주 맘 에 들 어요	<P>
무엇 보다 배송 이 빠르 구요	<N>
가격 대비 성능 강추	<P>
그러나 전 제집 에 비행기 가 이륙 하 나 하 았 습니다	<N>
아내 가 아주 좋아하 아요	<P>
소음 이 엄청나 더군요	<N>
가격 도 저렴 하 고 성능 도 좋 고 소음 도 적 고 좋 습니다	<P>
좀 심하 게 많이 나 ㅂ니다	<N>
기사 분 아주 친절 하 시 고 세심 하 ㄴ 배려 에 감사 하 는 마음 이 ㅂ니다	<P>
진동 도 심하 구요	<N>
가격 도 저렴 하 고 성능 도 좋 네요	<P>
게다가 차이 가 그리 엄청나리라곤 상상 도 못하 았 습니다	<N>
설치 해 주 신분 도 엄청 친절 하 았 어요	<P>
소음땜에 세탁기 를 바꾸 시 는 분 들 은 피하 시 는 것 이 좋 을 듯 하 ㅂ니다	<N>
대 만족	<P>
설치 하 아 주 시 ㄴ 기사 분 도 친절 하 시 고 그냥 만족스럽습니다	<N>
가격 도 저렴 하 고 오늘 빨래 하 았 는데 괜찮 아요	<P>
물건 구매 하 ㄴ지 일하 고도 시간 이 넘어서 어야 물건 을 받 았 네요	<N>
잘 산 것 같 아요	<P>
오프라인보더 몇 만 원 더 싸 길래 조금아낄까하구 구입 하 았 는데 이것 이 무엇 이 냐	<N>
가격 도 저렴 하 고 원룸 에 사용 하 기 딱 좋 고 배송 도 빠르 고 설치 하 시 는 기사 님 친절 하 고 맘에듬니다	<P>
일 동안 세탁소 랑 빨래 방 에 다 가 쓰 ㄴ 돈 이 더 많 으니 완전 손 하 아 보 았 네요	<N>
가격 도 저렴 하 고 잘 빨리 네 요	<P>
차라리 오프라인 가 아서 시원 하 게 구입 하 시 고 당일 배 송 하 시 어요	<N>
가격 도 저렴 하 고 좋 아요	<P>
쩝쩝 이 네 진짜	<N>
아직 세탁 은 안 하 아 보 았 지만 전기 효율 도 등급 이 고 색상 이나 디자인 다 맘 에 들 네 요	<P>
물건 깔끔 하 고 지금 세탁기 돌리 고 있 는데 다행히 어머님 이 좋 다고 하 시 네요	<N>
가격 도 저렴 하 고 크기 도 적당 하 고 대단히 만족 하 ㅂ니다	<P>
일 주문 하 ㄴ걸 오늘 받 았 는데 기다리 기 무지 힘들 더군요	<N>
가격 도 저렴 하 고 크기 도 적당 하 아 보이 고 설치 도 잘 하 아 주 시 니 좋 은 거 같 네요	<P>
더군다나 월 이 ㄹ 두 분 기념일 이 라 선물 하 ㄴ 것 이 ㄴ데 선물 에 의미 도 없 어 지 어 버리 고 이래저래 속상하 았 던 거래 이 었 습니다	<N>
기사 님 도 친절 하 시 구요	<P>
근데 기사 분 한테 왜 이렇 게 배송 이 늦 어 지 었 냐고 묻 었 더니 모르 는 일 이 라는 듯 재고 있 는데 왜 늦 었 지 하 시 더군 요	<N>
가격 도 저렴 하 고 품질 도 좋 아요	<P>
에 휴 전화 걷 어서 항의 하 려다 힘빠져서 어디 쪽 말 이 맞 는 것 이 ㄴ지 모르 겠 지만 오긴온거니까	<N>
설치 기사 님 도 친절 하 시 고 만족 하 ㅂ니다	<P>
잘 쓰 ㄹ게요	<N>
가격 도 저렴 하 고 모터 도 잘 돌아가 고 좋 아요	<P>
물건 받 기 까지 너무 힘들 었 어요	<N>
암튼 가격 대비 대 만족 입 니 당	<P>
엘지 에 실망 이 ㅂ니다	<N>
가격 도 저렴 하 고 배송 도 빠르 고 배달 기사 님 도 친절 하 시 고 좋 습니다	<P>
앞 으로 빠르 ㄴ 배송 부탁 하 ㅂ니다	<N>
가격 도 저렴 하 고 설치 기사 님 도 친절 하 시 고 세탁 도 잘 되 어요	<P>
그 외 에 는 다 좋 네요	<N>
가격 도 저렴 하 고 성능 도 좋 네요	<P>
물건 좋 고 배송 기사 님 좋 고 다 좋 은데 엄청 늦 게 오 았 다는 거	<N>
기사 님 친절 하 았 고 대체 적 으로 좋 았 네요	<P>
설치 가 안 되 어서 밖굴려고 하 었 으나 빌트 인 으로 기다리 ㄴ 시간 이 있 어서 그냥 쓰 어야 하 겠 네	<N>
가격 도 저렴 하 고 세탁기 도 사진 보다 예쁘 네요	<P>
물건 좋 고 빠르 ㄴ 배송 좋 구 감사 하 ㅂ니다	<N>
가격 도 저 렴 하 고 디자인 도 무난 하 고 좋 습니다	<P>
소리 가 좀 크 ㄴ 거 같 음	<N>
가격 도 저렴 하 고 화면 으로 보 았 을 때 보다 더 이쁘 더라구 요	<P>
자취방 이 ㄴ데 민망 하 ㄹ 정도 로 좀 크 ㄴ 거 같 네 여	<N>
아담 사이즈 에 소음 도 적 고 배송 하 시 는 기사 분 도 친철했그요	<P>
그거빼면 괜찬은듯	<N>
강추예요	<P>
물건 도 좋 고 가격 도 싸 고 배송 도 빠르 고 성능 도 좋 고 매우 만족 하 ㅂ니다	<N>
암튼 만족 이 ㅂ니다	<P>
어쨋든 마니 파시 구 여	<N>
가격 도 저 렴 하 고 배달 기사 님 도 넘 친절 하 ㅂ니다	<P>
물건 만 파 라 처먹 으면 끝 이 냐	<N>
전 에 도 대우 제품 을 쓰 었 는데 대 우 강추입니다	<P>
소비자 알 기 를 웃습게아는 홈쇼핑 이 네	<N>
가격 도 저렴 하 구 건조 기능 까지 되 는 거 이 라 더 좋 네요	<P>
이런 대 서 다시 물건 을 사 겠 냐	<N>
대우 세탁기 좋 네요	<P>
물건 배 송 하 신분 이 설치 까지 하 아 주 시 었 는데 너무 친절 하 고 설치 도 잘 하 아 주 시 어서 감사 하 아요	<N>
가격 도 저렴 하 면서 디자인 두 깔끔 하 니 예뿌네여	<P>
기사 님 두 친절 하 시 고 다 좋 은데 어찌나 배송 이 늦 는지	<N>
울 엄마 사다드린건데 잘빨린다구 좋아하셔여	<P>
급 세탁 하 시 어야 할 분 들 은 감안 하 시 어야 하 겠 네 여	<N>
가격 도 저렴 하 면서 크 ㄴ 용량 으로 구입 하 ㄹ 수 있 어 좋 아요	<P>
물건 은 괜찮 은 거 같 은데 배송이	<N>
그리고 배송 기사 아저씨 너무 친 철 하 시 네요	<P>
배송 기사 가 금요일 날 가지 어다 주 ㄴ다고 하 았 다가 다시 또 다음 주 에 가지 어다 주 ㄴ다고 하 었 다가	<N>
디자인 도 깔끔 하 ㅂ니다	<P>
물건 은 마음 에 들 어요	<N>
다른 브랜드 에 비하 아서 저렴 하 ㄴ 가격 이 ㅁ 에 도 불구 하 고 삶 는 기능 까지 있 어서 더 좋 은 것 같 아요	<P>
다만 배송 이 늦 고 연락 을 하 었 는데 도 바로 답장 을 주 시 ㄴ다고 하 고 오 지 않 아 많이 기다리 었 습니다	<N>
배송도 빠르 고 기사 님 도 친절 하 게 설치 하 아 주 시 고 추천합니당	<P>
그래도 물건 을 받 고 보 니 마음 에 들 ㄴ다고 하 아서 다행 이 었 습니다	<N>
가격 도 저렴 하 ㄴ데 성능 이 괜찮 습니다	<P>
여유 있 으시 ㄴ 분 들 은 참 좋 을 것 같 아요	<N>
정말 후회 가 없 네요	<P>
물건 은 추천 하 고 싶 은데 배송이 조금 은 늦 는 것 같 네요	<N>
취업 으로 독립 하 아서 이제 나 의 가전제품 을 사 게 되 는데 부모 님 들 이 예전 에 삼성 이나 제품 만 고집 하 았 는데 대우 제품 이 직접 이렇 게 성능 이 좋 은지 처음 알 았 습니다	<P>
판매자 의 연락처 가 게시판 으로 밖 에 없 는 것 도 아쉽 고 질문 에 대하 ㄴ 답변 이 조금 늦 는 점 도 아쉽 네요	<N>
가격 도 저렵 하 고 일반 적 으로 쓰 기에 아주 좋 습니다	<P>
조금 만 신경 쓰 면 좋 은 판매자 가 되 ㄹ 수 있 을 것 같 은데	<N>
잘 선택 하 ㄴ 것 같 아요	<P>
아무튼 많이 팔 시 고 사업 번창 하 시 기 ㄹ 바라 ㅂ니다	<N>
강추합니다	<P>
약하 ㄴ 달 정도 물건 오기 전 에 쓰 시 던 세탁기 남 주 이 지 마 세 요	<N>
가격 도 적당 하 고 무엇 보다 도 맘 에 들 는 것 은 섬유유연제가 자동 으로 투입 되 어 일단 동작 만 시키 어 놓 으면 신경 쓰 ㄹ 것 이 없 네요	<P>
구매 하 시 는 분 들 감안 하 시 어서 구매 하 시 기 ㄹ	<N>
꽤 괜찮 은 상품 이 라고 생각 하 ㅂ니다	<P>
물건 자체 는 별문제 가 없 어 보이 ㅂ니다 만 설치 하 러 오 시 ㄴ 분 이 거의 물건 만 던지 어 놓 고 가 아 버리 는 수준 이 라 앞 으로 서비스 가 심히 걱정 되 는 수준 이 었 읍니다	<N>
배송도 친절 하고 비교적 빠르 ㄴ 시일 에 되 었 구요	<P>
물건 자체 는 크 ㄴ 무리 없이 괜찮 습니다	<N>
새 거 이 라서 그러 ㄴ지 세탁 이 빨리 말끔 하 게 되 어서 좋 네요	<P>
물건잘밧앗읍니다	<N>
배송 하 시 는 분 들 도 정말 친 절하 시 고 추천 하 ㅂ니다	<P>
근 데 여 설치 가 이상해 서 이 어 다 시 해 주세 이 어	<N>
가격 도 정말 저렴 하 고 중고 사 려다 돈 조금 더 보태 어서 새 거 사 았 는데 잘 하 ㄴ 듯 하 네 요	<P>
물건 좋 고 특히 설치 기사 님 이 아주 친절 하 고 잘 하 시 ㅂ니다	<N>
가격 도 좋 고 상품 도 좋 다	<P>
물건 좋 아요	<N>
가격 도 좋 고 상품 도 좋 다	<P>
물 높이 가 고 에 서 작동 되 ㄹ 때 탈수 되 어 돌아가 는 과정 에서 힘 이 약하 ㄴ 것 같 아요	<N>
가격 도 좋고기사분도 친 절하 시 고 아 주 좋 아요	<P>
무게 가 무겁 면 세탁기 가 버겁 ㄴ 듯 하 아 보이 ㅂ니다	<N>
가격 도 좋구여	<P>
품질 은 좀 아쉽 구요	<N>
배송도 좋구여	<P>
그 외 서비스 는 너무 좋 습니다	<N>
모양 도 좋구여	<P>
물건 은 넘 좋 습니다	<N>
맘 에 아주 아주 쏘옥 들 어서 좋 아 여	<P>
물론 가격 이 저렴 하 기 ㄴ 하지만 엘지 제품 에 비하 면 많이 시끄럽 네요	<N>
대리점 아저씨 도 아주 친절 하 아서 좋구여	<P>
배송도 조금 느리 었 고	<N>
가격 도 착하 고 기능 은 보통 세탁기 괜찮 아요	<P>
그래도 가격 대비 만족스럽습니다	<N>
가격 도 착하 고 배송 도 친 철 하 고	<P>
다만 배송 손 빨래 하 느라 엄청 힘들 었 어요	<N>
가격 도 착하 고 기능 도 쓰 ㄹ 만 하 고요	<P>
디자인 과 색상 을 신경 쓰 었 으면 하 ㅂ니다	<N>
가격 도 품질 도 서비스 도 만족 하 ㅂ니다	<P>
뭐 이 어 이것	<N>
가격 도 성능 도 맘 에 들 어요	<P>
월 일 주문 하 고 현금 결제 까지 하 었 구만 왜 여태껏 아무 연락 도 없 고 배송도 안 되 나	<N>
이 가격 에 이 정도 면 아주 만족 하 ㅂ니다	<P>
이것 사 아 길 ㄴ가	<N>
선택 사항 도 잘 되 있 어서 참 좋 네요	<P>
뭐 이렇 ㄴ데 가 아 다 있 습니까	<N>
가격 도 맘 에 들 고 성능 도 좋 고 모두 모두	<P>
산지 주가 달 되 가 는데 배송 은 커녕 아직 준비 중 이 라고 하 고 아니 그러 면 연락 이 라도 하 아 주 어야 하 는 거 아닙니까	<N>
가격 도 저렴 하 고 품질 도 굿 이 에요	<P>
사지 마 세 요	<N>
기사 분 도 친절 하 시 고 강추입니다	<P>
절대 사지 마 세 요	<N>
특히설치하시는기사님넘친절하시고다맘에드네요	<P>
미리 연락 을 주 시 어서 저의 시간 에 맞쳐주시고 친절 도 최고 설명 도 최고 뒷처리도 최고 이 ㅂ니다	<N>
넘저렴한가격에드럼세탁기를사게되서지갑주운기분이네요	<P>
다만 저렴 하 ㄴ 모델 이 라서 그러 ㄴ지 세탁 시 모터 소리 가 크 ㄴ 편 이 ㅂ니다	<N>
가격 도 저렵 하 고 좋 아요	<P>
특히 탈수 하 ㄹ 때 는 모터 소리 가 더 크 게 느끼 어 지 는군 요	<N>
가격 두 넘 저렴 하 구 배송도 제 시간 에 잘 하 아 주 시 었 어요	<P>
가격 이 저렴 하 니 감수 하 아야 하 ㄹ 부분 이 ㄴ 것 같 습니다	<N>
덥 ㄴ 날씨 에 땀 을 비 오 듯 흘리 시 면서 도 배송 기사 님 께서 친절 하 게 사용 설명 도 잘 하 아 주 시 었 구요	<P>
대신 크 ㄴ 빨래 하 기 는 좀 힘들 겠 네요	<N>
가격 두 맘 에 들 고요	<P>
싸 니깐 괜찮 아요	<N>
특히 배달 기사 분 이 넘 친절 하 아 기분 이 좋 네요	<P>
쇼핑 후 배송기 간 까지 조금 많이 걸리 어서 답답 하 ㅁ 이 있 었 음	<N>
가격 두 싸 구 배송 도 빠르 고 기사 님 도 친절 하 고 좋 네요	<P>
미용실 에서 사용 하 는데 참으로 좋 습니다	<N>
가격 대비 매우 만족 하 ㅂ니다	<P>
만 이 팔 시 구 사업 번창 하 세 여	<N>
가격 두 저렴 하 고 세탁 하 는데 전혀 지장 없 습니다	<P>
이것 이 말 이 되 ㅂ니까	<N>
좋 아요	<P>
배달 기사 분 도 친절 하 시 고 빠르 ㄴ 배송 도 좋 았 습니다	<N>
가격 두 저렴 하 고 디자인 도 굿 이 네요	<P>
배달 이 일주일 이상 걸리 어서 기다리 는데 힘 을 많이 뺏 습니다	<N>
가격땜에 별로 안 좋 으면 어떡하 나 걱정 하 았 는데 배송 도 빠르 고 오 자마자 한번 돌리 어 보 았 는데 소리 도 작 고 너무 좋 네요	<P>
그러나 물건 은 좋 았 습니다	<N>
가격 대비 너무 너무 만족 하 ㅂ니다	<P>
물건 은 좋을꼬예여	<N>
빠르 ㄴ 배송 과 함께 깔끔 하 ㄴ 설치 그리고 무엇 보다 제품 에 쏙 빠지 었 습니다	<P>
근데 주말 에 설치 를 하 아야 하 ㄴ다고 하 었 는데 평일 날 나오 아야 하 ㄴ다기에 근무 중 에 집 에 들리 었 습니다	<N>
강추예요	<P>
배달 하 아 주 시 ㄴ 분 도 친절 하 시 고 물건 도 좋 습니다	<N>
가격 만족 배송 만족	<P>
배송 기다리 다 목 빠지 는 줄 알 았 어요	<N>
배송 및 친절 에 감동	<P>
하지만 저렴 하 ㄴ 가격 에 잘 살 ㄴ 것 같 네요	<N>
강추 일 이 ㅂ니다	<P>
배송 늦 은 거 빼 곤 괜찮 네요	<N>
가격만족성능만족배송만족서어비스만족모두가좋네요	<P>
근데 생각 보다 드럼통 이 적 네요	<N>
적극 추천 하 ㅂ니다	<P>
그것 ㄴ 그렇 고 선풍기 도 같이 오 았 으면 좋 았 을 것 이 ㄴ데 아직 선풍기 가 안와 서	<N>
가격 만족 품질 만족 디자인 만족	<P>
배송 빠르 구요 설치 하 아 주 시 는 분 들 너무 친절 하 아서 기분 좋 았 습니다	<N>
굿 이 에요	<P>
사실 가격 은 다소 불만족스럽습니다	<N>
가격 만족 품질 만족 이 ㅂ니다	<P>
배송 빠르 아서 좋 았 구요	<N>
타사 제품 도 좋 겠 지만 집안 의 전자 제품 을 동일 메이커 로 통일 시키 니 때 도 유리 하 ㄹ 것 같 고 좋 아요	<P>
배송 설치 해주 신 기사 님 너무너무 수고 하 시 었 습니다	<N>
가격 보다 괜찮 아요	<P>
배송 엄청 느리 어 전화 이 라도 좀 주 시 지	<N>
추천 하 ㅂ니다	<P>
벌써 일 지나 았 네	<N>
배송도 바로 되 구 좋 네요	<P>
이것 일 배송 보상 받 는 거 아닌가	<N>
갑자기 세탁기 가 고장 나 아서 구입 하 ㄴ 것 이 ㄴ데 담 날 바루 배송 되 어서 넘 좋 았 어요	<P>
언제 오르 아 나	<N>
집 이 층 이 라 갖 고 오 시 ㄴ 기사 님 들 고생 많 이 하 시 었 을 터 이 ㄴ데 참 친절 하 시 더라구 요	<P>
빨래 는 늘 어 만 가 고 옷 이 썩 네	<N>
가격싸고 배송 빠르 구 좋 아요 좋 아	<P>
배송 엄청 빠르 더군요	<N>
가격싸고 배송 빠르 구 좋 아요 좋 아	<P>
배송 완전 굿 이 고요	<N>
가격싸고 친절 배 송 빠르 ㄴ 배송 최고 이 ㅂ니다	<P>
배송 완전 만들 어 오 오 는 줄 알 았 음	<N>
가격싸고 제품 좋 고 배송 좋 고 이제 는 대우 도 대우 받 아야 마땅 하 ㅂ니다	<P>
주 걸리 ㄴ 듯	<N>
사용 후기 가 상당히 좋 다는 분 들 이 많 아서 구매 하 았 는 데 이 요 생각 보 담 괜찮 던데요	<P>
완전 손 발 부르 터 요	<N>
가격 에 비하 아 잔 고장 없이 잘 쓰 고 있 으며 저 흰 회사 에서 쓰 는 것 이 라 튼튼 하 ㄴ걸 로 사 았 는데 사 기 ㄹ 잘 하 ㄴ 것 같 네요	<P>
손 빨래 하 아	?N>
가격 에 비하 아 제품 이 맘 에 들 었 습니다	<P>
배송 완전 짜증납니다	<N>
오래 사용 하 아 보 아야 알 겠 지만 현재 는 맘 에 들 고 배송 시 설치 를 바로 하 ㄹ 수 없 는 여건 이 어서 자가 설치 하 아서 사용 하 고 있 지만 문제점 은 없 고 일반 세탁기 에 비하 아 물 사용량 도 적 고 섬세 하 ㄴ 면 이 있 는 것 같 아서 잘 사 았 다는 생각 이 들 ㅂ니다	<P>
구매 이주만 에 배송 받 았 습니다	<N>
가격 에 비하 아 규모 도 크 고 세탁 도 잘 되 고 깔끔 하 ㄴ 디 자 이 ㄴ데	<P>
배송 관련 확인 전화 달 라고 두 번 이나 전화 하 아서 얘기 하 었 는데 전화 한통 없 더니 구매 확정 하 아 달 라고 전화 하 ㅂ니까	<N>
아무튼 다 좋 네요	<P>
자주 구매 하 는 물품 도 아니 니 두 번 안사면 그만 이 지만 좀 심하 군 요	<N>
가격 에 비하 아 너무 좋 네요	<P>
배송 관련 태도 는	<N>
작 으면서 도 최신 드럼 세탁 기 이 라 좋 은 상품 감사 하 ㅂ니다	<P>
배송 일주일 만 에 되 ㄴ 듯 하 고 설치 도 대충 하 아 주 고 가 시 네요	<N>
가격 에 비하 아 넘 좋 아요	<P>
세탁기 배수관 도 제 가 다 설치 하 아 두 었 는데 좀 깔끔 하 게 하 아 주 시 었 으면 좋 았 을 터 이 ㄴ데	<N>
디자인 도 예쁘 네요	<P>
다른 대기업 나 에 분 들 좀 배우 어야 하 겠 네요	<N>
가격 에 비하 아 아주 맘 에 듬	<P>
배송 잘 받 았 습니다	<N>
괜찮 아요	<P>
배송 정말 빠르 게 하 아 주 시 었 어요	<N>
가격 에 비하 아 엄첨 좋 네요	<P>
기사 님 이 친절 하 게 잘 설치 하 아 주 시 었 어요	<N>
가격 에 비하 아 잘 산 것 같 습니다	<P>
일주일 전 에 화물택배로배송 하 었 다고 메세지 보내 고 월요일 간 다 수요 일 간 다 토요일 간 다 화요일 까지 는 가 ㄴ다 지방 이 라 배송 이 지연 되 ㄴ다	<N>
빨래 가 깨끗이 되 는 것 같 아요	<P>
어제 전화 하 아서 가격 도 구매 전 보다 만원 내리 고 하 아서 전화 하 았 더니 사기 싫 으면 말 라는 말투 와 마트 가 아서 사 라는 성의 없 는 대답	<N>
가격 에 비하 아 좋 습니다	<P>
아직 도 못 받 은 사람 이 많 다는 말 등 순간 만 모면 하 는 되 는 듯 하 ㄴ 성의 없 는 말투 로 세탁기 도 못 받 고 결국 취소 했내요	<N>
가격 에 비하 아 좋 은 듯	<P>
이렇 ㄹ 줄 알 았 으면 다른 곳 에서 살 ㄹ 걸 이 업체 신뢰감 이 안 가 는 업체 일 이 ㅂ니다	<N>
가격 에 비하 아 품질 좋 은 것 같 아요	<P>
소비자 오 아 약속 을 너무 쉽 게 생각 하 는 것 같 아요	<N>
가격 에 비하 아 품질 좋 습니다	<P>
너무 기분 이 너무 나쁘 았 어요	<N>
삼성 이나 엘지 끄 어 보 단 가격 에 비하 아 품질 은 뒤지 지 않 네 여	<P>
다른 곳 이용 하 시 어요	<N>
가격 에 비하 아서 대 만족 이 ㅂ니다	<P>
다른 곳 에서 사 았 는데 산지 한 시간 만 에 배송 하 었 다고 메세지 오 았 어요	<N>
가격 에 비하 아서 상품 이 정말 좋 구요	<P>
하지만 배송이 다른 타 사 보다 넘 늦 어서	<N>
배송 서비스 도 빠르 고 상당히 친절 하 시 더군 요	<P>
가격 도 저렴 하 아서 부담 없이 살 ㄹ 수 있 어 넘 좋 습니다	<N>
가격 에 비하 아서 생각 보다 괜찮 네요	<P>
배송 해주 신 기사 님 도 친 절하 고 디자인 도 깔끔 하 네 요	<N>
또한 제품 도 마음 에 들 고요	<P>
좀 작 습니다	<N>
적극 추천 하 ㅂ니다	<P>
수평맞추길 잘 하 면 진동 은 어느 정도 잡 는데 소음 은 많이 작아지 지 ㄴ 않 네 요	<N>
강추 일 이 ㅂ니다	<P>
그런데로 데 전 에 쓰 던 로 보다 작 다는 느낌 이	<N>
가격 에 비하 아서 아주 만족 하 네 요	<P>
나만그런건가아님슬림하게만든건지암튼작다는느낌이 강하 네 여	<N>
가격 에 비하 아서 제품 은 괜찮 은 거 같 네요	<P>
배송일 걸리 었 구요	<N>
가격 에 비하 아 성능 이 좋 습니다	<P>
배송 과 서비스 가 너무 실망 스럽 네 요	<N>
권하 고 싶 네 요	<P>
지정일 배송 약속 하 고 주문 하 았 는데 당일 날 되 어서 는 무조건 안 되 ㄴ다고 하 고 전화 도 잘 받 지 않 고	<N>
가격 에 비하 아 잘 살 ㄴ 거 같 아요	<P>
화 까지 내 면서 하 니까 겨우 일 초과 하 아서 갖 다 주 었 는데 퇴근 후 에 갖 다 달 라고 하 아도 무시 하 고 학년 아들 혼자 있 는데 두 고 전화 도 안 하 고 가 았 네요	<N>
가격 은 당연히 싸 고 제품 도 만족 하 ㅂ니다	<P>
마냥 믿 고 기다리 었 으면 주가 넘 게 걸리 었 을 거 이 에요	<N>
담 주 나 오 ㄹ 줄 알 고 있 었 는 데 빨리 설치 가 되 어서 고맙 습니다	<P>
다행히 물건 은 좋 은 것 같 지만 기분 이 상하 아서 크 ㄴ 애정 이 안가 네 요	<N>
가격 은 매우 만족 이 고 디자인 이 라든지 서비스 도 괜찮 습니다	<P>
짜증 남	<N>
배송도 사전 에 전화 주 시 고 좋 습니다	<P>
배송기 간 이 길 어 지 ㄹ까 걱정 하 았 는데 월요일 주문 하 아서 금요일 받 았 습니다	<N>
일단 사고 보 니 디자인 은 정말 예쁘 더라구 요	<P>
배송기 간 이 넘 하 ㄴ데요	<N>
하여튼 구매 잘 하 고 가 ㅂ니다	<P>
휴 옷 을 세탁 을 못하 아서	<N>
가격 이 가장 저렴 하 아서 좋 구요	<P>
배송 기사 님 넘 친절 하 게 설치 잘 하 아 주 시 고 설명 도 잘 하 아 주 시 어서 아주 잘 쓰 고 있 습니다	<N>
배송 기사 님 친절 하 게 설치 하 아 주 시 어서 만족스럽습니다	<P>
배송 이 너무 느리 어 요	<N>
다르 ㄴ 제 품 과 비교 하 아서 괜찮 은 거 같 구요	<P>
매장 에서 직접 상품 을 본 후 구입 하 ㄴ 거 이 라 디자인 이나 성능 은 마음 에 들 ㅂ니다	<N>
여러 기능 이 있 어서 잘 이용 하 ㄹ 꺼 같 아요	<P>
에고 세탁 기 하나 살 는 데 시 간 을 넘 잡아먹 었 네요	<N>
가격 이 너무 싸 아서 다른 브랜드 에 비하 아 별루 안 좋 은가 하 었 는데 너무 괜찮 아 여	<P>
배송 기사 분 이 열결호스 누수 이야기 로 혼란 을 주 지 않 았 음	<N>
가격 이 너무 저렴 하 아서 약간 의 의심 이 있 었 는데 오 자마자 이불 빨래 를 하 아 보 았 는데 때 가 너무 자 ㄹ 지 네 요	<P>
배송 기사 분 이 집안 에 들여놓 아 주 지 않 으시 었 어요	<N>
만족 이 ㅂ니다	<P>
설치 하 시 는 분 이 그렇 게 하 면 안 되 ㄴ다네 요	<N>
가격 이 너무 저렴 하 아서 혹시 뭐 가 잘못 되 ㄴ 것 이 아닌가 싶 었 는데 사용 하 아 보 ㄴ 결과 너무 좋 습니다	<P>
제품 이 영 허접합니다	<N>
엄마 선물 로 하 아 드리 었 는데 엄마 가 너무 좋 아 하 시 네요	<P>
엄마 한테 한 소리 들 었 습니다	<N>
기사 분 들 도 친절히 설명 하 아 주 시 고 암튼 만족 이 ㅂ니다	<P>
가전제품 이 라 이왕산 거 그냥 쓰 ㄴ다지만 일 이 십 만 원 도 아니 ㄴ 데	<N>
가격 이 넘 싸 아서 좀 그러 는데요 생각 보다 넘 좋 아요	<P>
세탁기 같 은 제품 은 정말 신중히 생각 하 아야 하 ㄹ 것 같 아요	<N>
잘샀는 생각 이 들 어요	<P>
월 이 ㄹ 날자 준수 바람 아직 세탁기 못 받 음	<N>
설치 하 아 주 시 는 분 도 친절 하 게 작동법 도 알리 어 주 시 구요	<P>
상품 은 세탁 하 아 보 았 는데 일 반 세탁기 보다 시간 이 길 고 물 높이 조절 을 맘데로 하 ㄹ 수 없 다는 것 이 불편 한 것 같 아요	<N>
좋 습니다	<P>
탈수 시 소음 이 좀 있 고요	<N>
가격 이 넘 저렴 하 구 실용 적 이 네요	<P>
삶 음 기능 을 사용 하 아 보 았 는데 직접 삶 는 것 이 나은 것 같 아요	<N>
여러 모 루 경제 적 이 구 넘 좋 아요	<P>
깨끗 하 게 안 되 네 요	<N>
가격 이 다른 세탁기 들 에 비하 아 싸 아서 구입 하 았 는데 잘 선택 하 ㄴ 것 같 아요	<P>
아무래도 그 기능 은 사용 하 지 않 을 것 같 아요	<N>
주문 하 ㄴ 지 일 만 에 받 을 수 있 었 고 곧바로 세탁 을 하 었 는데 별다르 ㄴ 소음 이나 문제 없이 깨끗이 빨렸습니다	<P>
그것 때문 에 사 았 는데 좀 그러 네 요	<N>
적극 추천 이 ㅂ니다	<P>
용량 은 전 에 쓰 던 세탁기 가 키 로 하 았 는데 이번 세탁기 통 이 더 작 은 것 같 아요	<N>
가격 이 다른 거 에 비하 아 너무 저렴 하 아서 혹시나 하 었 는데 세상 에 너무나 깨끗 하 ㄴ 빨래 에 빨래 하 는 기분 이 너무 좋 고 엉킴도 없이	<P>
이불 은 안 빨 아 보 았 지만 두껍 ㄴ 이불 은 좀 힘들 ㄹ 것 같 아요	<N>
세제 는 전용 세제 가 아니 ㄴ 먼저 쓰 던 것 이 남 아서 그냥 쓰 는데 도 깨끗 하 아요	<P>
묻 은 절약 이 되 ㄹ 것 같 은데 전기세 는 덜 나 오 ㄹ 것 같 네요	<N>
전용 세제 로 쓰 면 얼마나 더 깨끗 하 ㄹ까 요	<P>
일 반 세탁기 사서 속 시원 하 게 빨래할걸 하 고 후회 하 고 있 어요	<N>
정말 저렴 하 ㄴ 가격 에 잘 장만 하 ㄴ 거 같 아요	<P>
배송 날짜 도 지정 하 ㄴ 날짜 에 정확히 배송이 고 품질 이야 모 가격 대비 우수 하 죠	<N>
너무 빠르 아 깜짝 놀래 었 다는	<P>
배송늦어서 한참 기 달리 었 어요	<N>
세탁 하 아 보 았 는데 잘 빨리 는 것 같 고 무엇 보다 스팀삶기기능이 참 맘 에 들 ㅂ니다	<P>
그치 만 상품 은 좋 음	<N>
완전 강추입니다	<P>
배송도 늦 고 설치 도 안 하 아 주 고 그냥 가 아서 다시 전화 하 고	<N>
물론 고장 이 나 면 만들 ㄴ 곳 에서 하 아 주 겠 지만 강력 하 게 추천 하 ㅂ니다	<P>
세탁기 소음 이 너무 심하 네 요	<N>
친정 엄마 가 참 좋 아 하 었 습니다	<P>
차라리 돈 조금 더 주 고 괜찮 은 거 ㄹ 살 는 게 나 을 뻔 하 었 어요	<N>
맘 에 들 네 요	<P>
배송도 다른 곳 보다 빨 라고	<N>
가격 이 싸 아서 좋 은 것 같 음	<P>
그러 다 모터 가 나가 아서 새로 간 적 도 있 어요	<N>
용량 이 좀 작 아서 이불 은 힘들겟지만 잘 빨리 어 지 네 여	<P>
아무튼 이제 속 시원히 자주 이불 빨래 하 ㄹ 생각 에 기분 최곱니다	<N>
배송도 빠르 고 설치 도 잘 하 아 주 고 좋 은 물건 이 ㄴ 것 같 습니다	<P>
배송도 빠르 고 가격 도 저렴 하 고 세탁기 는 대우 제품 도 괜찮 은 것 같 아 친정 에 선물 하 아 드리 었 습니다	<N>
가격 이 저렴 하 여 걱정 하 았 는데 정말 이 런 가격 에 이런 제품 이 있 나 싶 네 요	<P>
근데 같이 시키 ㄴ 전자렌지는 왜 아직 안 오 나 모르 아요	<N>
가격 이 저렴 하 여 걱정 하 았 는데 쓰 ㄹ수록 편하 고 좋 아요	<P>
배송도 빠르 고 기사 아저씨 가 무지 친절 하 게 설치 하 아 주 시 었 습니다	<N>
조작법 도 간단 하 아서 어른 들 도 쉽 고 배송 기사 님 도 친절 하 시 네요	<P>
근 데 탈수 하 ㄹ 때 소리 가 넘 크 네요	<N>
가격 이 저렴 하 ㄴ 거 에 비하 면 타 회사 비싸 ㄴ 가격 의 세탁기 와 비교 하 ㄴ다면 거의 손색 이 없 습니다	<P>
좀 쓰 다 보 면 옆집 에서 항의 가 들어오 지 않 을까	<N>
늘 편하 게 사용 하 는 생활 용품 이 ㄴ데 가격 품질 에 비하 아 가격 은 너무 저렴 하 ㅂ니다	<P>
그거 빼 곤 다 좋 아요	<N>
시골 에 친정어머니 사 드리 었 는데 너무 좋 아 하 시 ㅂ니다	<P>
그래도 귀엽 습니다	<N>
배송 기사 님 도 친절 에 감사 드리 ㅂ니다	<P>
그런 건 좀 챙기 어 주 시 었 으면 좋 겠 어요	<N>
가격 이 저렴 하 ㄴ 것 이 가장 크 ㄴ 장점 같 네요	<P>
감사 하 ㅂ니다	<N>
중고 를 사 아도 만만 하 지 않 은 가격 이 던데 일단 만족 하 ㅂ니다	<P>
제 가 확인 을 못하 ㄴ 지 이 라 그리구 상품 젤 하단 에 약간 벌어지 ㄴ 것 ㄴ 어찌 하 아야 하 ㄴ지	<N>
가격 이 저렴 하 아서 구입 하 았 어요	<P>
배송도 원하 는 날짜 에 맞추 어서 잘 지키 어 주 시 고 기사 분 도 너무 친절 하 시 었 습니다	<N>
오 자마자 차렵 이불 빨 아 보 았 는데 잘 빨리 네 요	<P>
통 돌 이 설치 하 고 찰랑거리 는 물 속 에서 이불 이 휭휭 돌아가 는데 정말 속 시원 하 더군요	<N>
무엇 보다 드럼 세탁 기 폐가 전 수거 하 아 가 시 느라 아저씨 고생 하 시 었 어요	<P>
싼맛 에 쓰 기에 좋 아요	<N>
가격 이 좋 고 소음 도 거의 없 네요	<P>
단지 이전 것 보다 세탁 시간 이 오래 걸리 는 것 이 흠	<N>
디자인 도 괜찮 고	<P>
배송 두 늦 구	<N>
혼자사니깐딱인거같아요	<P>
싸구려 이 라 그러 ㄴ지 섬유유연제 넣 을 타이밍 에 소리 는 커녕 넣 을 수 있 는 받이 통 두 없 구	<N>
디자인도이뿌고 설치 하 아 주 시 ㄴ 기사 님 도 너무 친절 하 시 고 요	<P>
완전 실망 이 네요	<N>
설치 하 고 사용법 관리법 도 다 설명 하 아 주 시 고	<P>
구매 잘못 하 ㄴ 듯 싶 네 요	<N>
가격 이 비하 아 최고 이 ㄴ 거 같 은데 여	<P>
배송 두 빠르 고 이번 이 두 번 째 구매 이 ㄴ데 엄마 네 이 어	<N>
혼자사니깐딱인거같아요	<P>
그래두 많이 들어가던뎅	<N>
디자인도이뿌고설치해주신 기사 님 도 너무 친절 하 시 고 요	<P>
배송 두 빠르 구요	<N>
설치 하 고 사용법 관리법 도 다 설명 하 아 주 시 고	<P>
크기 두 다 들 말씀 하 시 ㄴ 것 처럼 작 아 보 여 여	<N>
가격 저 렴 실용 적 이 ㅂ니다	<P>
이불 이 빨 아 지 ㄴ지 의심스럽네여	<N>
배송도 빠르 고 직접 올리 어다 주 어 아주 편하 았 습니다	<P>
아저씨 이 구 친절 하 시 구 조 아 여	<N>
가격 저 렴 하 게 약정 도 싸 게 구입 하 아서 가격 만족 하 구요	<P>
월 말 일 쯤 주문 하 았 는데 어제 밤 에 도착 하 았 네요	<N>
참고 로 드럼 보다 좋 은 점 이 많 은 거 같 아요	<P>
오 시 ㄴ다는 날짜 에 기다리 고 있 었 는데 연락 도 없이 펑크 내 시 고	<N>
소비 전력 낮 아 전기 요금 적 게 내 고 적 은 빨래 빨리 끝 내 고 하 염 없이 세월 만 잡아먹 는 드럼 보다 좋 네요	<P>
외출 도 못하 고 하루 종일 기다리 느라 짜증 이 빠 시	<N>
아참 그러 구 마누라 통 이 힘차 게 돌아가 아서 좋 다구 하 네 요	<P>
암튼 짜증 지대 로 에 여	<N>
설치 기사 분 도 친절 하 고 사용법 도 친절히 알리 어 주 고 도 분명 좋 을 것 으로 기대 하 아요	<P>
배송땜에 약간 마찰 이 있 었 지만 선물 로 사 아 주 었 는데 받 은 사람 이 너무 좋다네요	<N>
감사 감사 하 ㅂ니다	<P>
왜케 통 이 작 은 것 이 ㄴ지	<N>
가격 저 렴 하 고 세탁 도 잘 되 고 나이드신 분 들 사용 하 기 편리 하 고 낮 아 서	<P>
잘 쓰 ㄹ께 요	<N>
가격좋고디자인수려하고대용량이라정말편리하고좋습니다	<P>
상품 구매 에서 배 송전 단계 는 실망 스럽 네 요	<N>
가장 중요 하 ㄴ 원하 는 날자 배 송 과 친절 하 ㄴ 설치	<P>
물품 이 ㄴ고 안 되 ㄴ 관계 로 말 ㄴ 지연 시간 이 넘 오 래 걸리 구요	<N>
양말 을 버리 면서 까지 설치 와 청소 도 돠와주시고 정말 만족 잇 었 습니다	<P>
무조건 입 고 관계 로 지연 만 되 ㄴ다고 하 니 정작 물품 받 으려고 하 ㄴ 날짜 에 물건 받 기 는 어렵 네요	<N>
가장 싸 고 가격 대비 쓰 ㄹ 만 하 ㄴ 제품 이 네 여	<P>
배송 받 기 까지 약간 시간 이 걸리 기 ㄴ 하 았 지만 배송 하 시 는 분 께서 넘 친절 하 시 고 요	<N>
배송 도 적당 하 고 기사 분 도 친절 하 시 고 만족 하 ㅂ니다	<P>
그래도 넘 괜찮 고 쓰 ㄹ 만 하 ㅂ니다	<N>
배송 에 관하 아서 ㄴ 만족 하 ㅂ니다	<P>
괜찮 습니다	<N>
가격 대비 용량 이 맘 에 들 군 요	<P>
빨래 는 기존 것 보다 더 잘 되 는 것 같 고 금액 도 마트 보다 만원 정도 저렴 하 아요	<N>
좋 아 와 요	<P>
처음 좀 물 을 많이 먹 어서 무겁 아 지 는 목욕 가 운 을 돌리 었 더니 세탁기 전체 가 좌우 로 흔들 ㄹ 리 면 서 소리 를 내 었 습니다	<N>
튼튼 하 니 아직 까지 는 좋 습니다	<P>
쫌 그것 이 실망	<N>
각격 대비 성능 만족 이 ㅂ니다	<P>
배송 시간 도 빠르 았 구요	<N>
특히 설치 기사 분 들 친 철 하 아서 좋 았 습니다	<P>
설치 하 아 주 시 는 기사 님 은 친절 하 시 었 다고 하시 네 여	<N>
하하	<P>
늦 으면 언제 쯤 배송 되 겠 다는 예정 일자 나 배 송이 지체 되 어 죄송 하 다는 사과 문자 하나 없 고 쇼핑몰 쪽 은 배송 이 늦 고 있 으니 취소 하 아도 관계없 다는 소리 나 하고	<N>
대 만족 이 ㅂ니다	<P>
심기 가 상당히 불편 하 ㅂ니다	<N>
대형 사이즈 로 디자인 굿 공간 싸이즈 굿 짱 이 ㅂ니다	<P>
물건 은 문 잠 기고 열리 는 소리 가 매우 거슬리 는 거 말 고는 대체로 괜찮 은 거 같 네요	<N>
배송도 빠르 고 설치 기사 분 이 친절 하 게 설치 하 아 주 시 었 어요	<P>
배송 에 문제 가 많 네요	<N>
좋 아요	<P>
늦 은 배송 하 며 벌 ㄴ가 오 아 따로 놀 는 배송 정보 하 며	<N>
베리 베 리 굿	<P>
기사 분 이 오 시 어서 친철히 설치 하 아 주 시 는 것 ㄴ 좋 았 습니다	<N>
감동 하 았 습니다	<P>
배송 에 문제 가 좀 있 었 지만 나름 대로 제품 에 는 만족 하 ㅂ니다	<N>
이 가격 에 이렇 게 좋 은 상품 을 받 다니 요	<P>
부피 도 적당 하 아서 공간 도 많이 안 차지 하 고 무난히 쓰 ㄹ 수 있 는 것 같 습니다	<N>
친 청 엄마 께 도 하 나 선물 하 아 드리 어야 되 ㄹ 것 같 아요	<P>
그래도 뭐 오 자마자 이불 빨래 해보 았 는데 문제 업 네 요	<N>
감사 하 ㅂ니다	<P>
배송 은 거의 한 달 정도 걸리 ㄴ 것 같 네요	<N>
아무튼 수고 들 하 시 었 습니다	<P>
개인 적 으로 세탁기 가 좀 급하 게 필요 하 았었 는데 빨래 산더미 처럼 밀리 다가 결국 손 빨래 하 고 배송 은 점	<N>
판매자님깨 감사드림니다	<P>
일단 오 기 ㄴ 오 았 으니까	<N>
기사 분 두 분 정말 친절 기사 로 추천 하 아 드리 고 싶 읍니다	<P>
그렇지만 배송 이 늦 으면 늦 는다는 전화 정도 는 하 아 주 어야 되 지 않 을지	<N>
정말 감사 드리 ㅂ니다	<P>
언제 쯤 도착 하 ㄹ 거 이 라는 그런 정도	<N>
강추	<P>
수고 하 시 어요	<N>
감사 하 ㅂ니다	<P>
어머니 사들이 었 는데 괜찮 다고 하 네 요	<N>
감사 하 ㅂ니다	<P>
배송 기사 님 이 너무 친절 하 시 어서 늦 었 지만 좋 았 어요	<N>
감동 이 에요	<P>
배송 은 마이 늦 었 지만 그런대로 참 을 만 은 하 었 지만 늦 기 ㄴ 하 았 어요	<N>
감사 하 ㅂ니다	<P>
모양 은 귀엽 고 깔끔 하 고 아직 오늘 오 아서 사용 은 안 하 아 보 았 지만 잘 쓰 ㄹ께 요	<N>
감사 하 아요	<P>
젠 반 적 이 ㄴ 서비스 에 대하 ㄴ 부문 은 상당히 만족 하 ㅂ니다만 제품 을 사용 하 아 보 았 더니 많 은 댓글 들 에 있 던 것 처럼 소음 이 상당히 심하 군 요	<N>
설치 기사 분 님 들 도 너무 감사 드리 ㅂ니다	<P>
탈수 때 는 물론 이 고 세탁 시 에 도 소음 이 무지 크 ㅂ니다	<N>
정말 세심 하 ㄴ 배려 너무나 감사 드리 ㅂ니다	<P>
아무래도 밤 에 ㄴ 사용 하 기 가 어렵 ㄹ 듯	<N>
감사 하 ㅂ니다	<P>
오전 에 세탁기 돌리 고 나가 아서 저녁 에 들어오 아서 빨래 를 꺼내 어야 하 ㄴ다면 주금 이 겠 죠	<N>
싸 게 잘 산거 같 아요	<P>
구매 가 망설이 어 지 ㅂ니다	<N>
감사 하 ㅂ니다	<P>
참 생각 보다 세탁물 도 조금 들어가 아 더 군 여	<N>
좋 아 은 상품 보 내 어 주 시 어서 감사 하구 요	<P>
이불 빨래 는 엄두 가 나 지 않 을 듯 하 네 요	<N>
새해 에 대 박 나 시 기 바라 ㅂ니다	<P>
배송 은 생각 처럼 빠르 지 ㄴ 않 았 지만 무난히 사용 하 기 에 ㄴ 괜찮 은 거 같 습니다	<N>
색상 이 회색 이 ㄴ지라 뚜껑 은 이뻐요	<P>
배송 은 솔직히 느리 어 요	<N>
특히 통 이 넘맘에 들 어요	<P>
그런데 사진 에서 보 는 거 랑 직접 보 는 거 랑 달 라요	<N>
적극 추천 하 ㅂ니다	<P>
배송 당일 날 아침 에 전화 를 주 니까 좀 난처 하 네 요	<N>
갑자기 세탁기 가 고장 나 아서 고심 하 던 중 에 가격 이 저렴 하 여 주문 하 았 는데 크기 도 많이 안 크 고 깨끗 하 아서 좋 습니다	<P>
많이 파 시 어요	<N>
갑자기 세탁기 가 고장 나 아서 급하 게 사 려고 보 니 가격 도 저렴 하 고 하 아서 구입 하 았 는데 역시 좋 네요	<P>
빨래 는 깨끗 하 게 잘 되 었 구요	<N>
딱히 드럼 세탁 기 같 은 거 안 쓰 시 ㄹ 거 이 면 요 제품 강추에요	<P>
배송 은 정말 늦 었 어요	<N>
갑자기 세탁기 가 고장 나 아서 급하 게 토욜 날 주문 하 았 는데 다음날 이 ㄴ 일요일 에 배 송이 되 어서 넘 기뻣어요	<P>
물량 이 부족 하 다면서 구입 하 ㄴ 날 로부터 열흘 뒤 쯤 오 았 나	<N>
가격 대비 넘 조코 쓰 ㄹ 만 하 ㅂ니다	<P>
그래도 배송 기사 분 들 이 설치 도 잘 하 아 주 시 고 가시 어서 좋았답니다	<N>
배송도 빠르 고 넘 조앗어요	<P>
배송 기사 님 들 이 친절히 잘 하 아 주 시 어서 감사 하 었 어요	<N>
갑자기 세탁기 가 고장 나 아서 손 빨래 하 고 난리 이 었 는데 좋 은 세탁기 가 생기 니 마음 이 흡족 하 구 ㄴ 요	<P>
친절 하 고 빠르 ㄴ 설치 로 너무 고맙 었 던 세탁기	<N>
그리고 세탁기 힘 이 좋드라구요	<P>
단 내부 통 도 작 아요	<N>
이쁘 게 잘 쓰 겠 습니다	<P>
하지만 대부분 이불 은 다 빨리 네 요	<N>
갑자기 친정 엄마 네 세탁기 가 고장 나 아서 사이트 를 뒤지 다가 옥션 에서 이 제품 이 가장 저렴 하 고 상품 평 이 좋 길래 구매 하 았 네요	<P>
배송 은 한마디 로 빵점 이 ㅂ니다	<N>
빨래 를 넣 고 돌리 니까 저 소음 에 새 거라 그렇 ㄴ 것 이 ㄴ가 빨래 잘 되 지 무척 만족 하 ㅂ니다	<P>
정확 하 ㄴ 배송 을 원하 시 면 만원 더 주 더라도 딴 곳 에서 사 시 어요	<N>
홀아비 생활 이 길 어 지 더라도 마냥 행복 하 ㄹ 것 같 네요	<P>
업체 와 직접 전화 약속 을 하 었 으나 그나마 도	<N>
히히히히히히	<P>
배송 은 금요일 밤 에 주문 화요일 낮 에 오 았 으니 뭐 잘 모르 겠 음	<N>
맘 에 들 ㅂ니다	<P>
고 거하 나 빼 면 설치 하 아 주 시 는 분 도 배송 당일 기사 분 친절히 전화 주 시 고	<N>
값싸 게 잘 살 ㄴ 것 같 아요	<P>
장난 치 어	<N>
가격 대비 만족 하 ㅂ니다	<P>
배송 을 너무오래기다렷습니다	<N>
값 은 저렴 하 게 배송 은 편리 하 게 구입 하 고 품질 은 대 만족 함	<P>
하지만 세탁기 가 절실햇던지라원래쓰던 보다 는 작 지만 그래두 좋 네 여	<N>
아주 잘 아 쓰 고 있 습니다	<P>
배송이 일 넘 게 걸리 ㄴ 거 같 아	<N>
세탁 도 잘 되 는 듯	<P>
타 아 싸이트보다 싸 아서 이쪽 으로 주문 하 ㄴ 것 이 ㄴ데 곧 하 아 주 ㄴ다고 하 아서 취소 하 고 다른 싸이트에서 주문 도 안 하 았 는데	<N>
제품 이 좁 은 공간 에 도 설치 되 어서 좋 다	<P>
배송만 빼 면 만족 하 ㅂ니다	<N>
강원도 평창 멀 ㄴ 곳 이 ㄴ 데 도 빠르 ㄴ 배송 고맙 고요	<P>
물품 은 쓰 ㄹ 만 하 네 요	<N>
저가 품 에 성능 도 좋 습니다	<P>
배송이 계속 지연 되 어 짜증 은 좀	<N>
강추	<P>
상품 은 괜찮 습니다	<N>
디자인 짱	<P>
배송 이 너무 느리 어	<N>
성능 짱	<P>
기다리 느라 좀 힘겹 었 지만	<N>
강력 추천	<P>
기사 님 들 도 친절 하 시 고 물건 도 가격 대비 예술 이 네 여	<N>
강추합니다	<P>
엄마 선물 로 사 드리 ㄴ 것 이 ㄴ데 거의 보름 이상 걸리 ㄴ 것 같 아 여	<N>
저렴 하 고 빨래 도 아주 잘 되 ㅂ니다	<P>
배송 이 너무 느리 었 어요	<N>
정말 잘 산 것 같 아요	<P>
일 만 에 받 았 는데 이것 도 고객 센터 에 항의 하 아서 겨우 받 은 것 같 아요	<N>
용량 도 이 라 넉넉 하 고 드럼 세탁기 이 ㅁ 에 도 불구 하 고 웬만 하 ㄴ 통 돌 이 보다 도 저렴 하 네 요	<P>
게다가 판매 측 여직원 이 너무 불 친절 하 아서 정말 최악 이 었 습니다	<N>
저 처럼 혼자 살 시 는 분 이나 둘이 사시 는 분 식구 가 많 지 않 으시 ㄴ 분 들 께 추천 하 ㅂ니다	<P>
상품 이 싸 고 설치 하 아 주 ㄴ 물류 쪽 직원 분 이 친절 하 아서 그나마 위안 이 되 었 습니다	<N>
때 도 자 ㄹ 지 이 고 용량 도 이 라 크 고 좋 습니다	<P>
배송 이 너무 느리 고 배송 이 늦 을 것 같 으면 사전 에 전화 안내 이 라도 하 아 주 어야 하 는데 그런 것 이 전혀 없 습니다	<N>
다음 에 전자 제품 사도 다음 에서 또 살 ㄹ까 하 ㅂ니다	<P>
개월 기다리 다 전화 하 았 더니 그제서야 대체 품 으로 하 면 안 되 겠 냐고	<N>
앞 으로 믿 고 구입 하 ㄹ	<P>
그래도 싸 게 는 산 것 같 아요	<N>
갠찬습니다	<P>
배송 이 너무 느리 군요	<N>
제 가 사용 안 하 아서 모르겟는데 아무튼 갠찬아요	<P>
배송만 빠르 다면 정말 만족할텐데	<N>
걱정 도 하 었 는데 배송 도 빠르 았 구요	<P>
배송 이 너무 늦 네요	<N>
친절 하 게 잘 설치 하 아 주 시 고 역시 드럼 이 좋 기 ㄴ 하 더라구요	<P>
배송 빼 고 는 뭐 특별히 나무라 ㄴ데 가 없 는 것 같 네요	<N>
옷감 이 안 상 하 는 것 같 은 암튼 너무너무 만족 하 ㅂ니다	<P>
배송 이 너무 늦 는 거 아닌가요	<N>
여러 가지 기능 이 있 는데 다 쓰 어 보 지 는 못하 았 는데 이제 아기 가 생기 ㄹ 거 이 라서 알 러 지 어 케어 가 있 어서 맘 에 들 네 요	<P>
전화 도 없 고 달랑 문자 하나 보내 어 놓 구 빨래 를 하 나 도 못하 고 있 잖아요	<N>
건조 기능 이 없 는 것 루 사 았 는데 전기세 두 말 니 나오 니까 세탁 기능 만 있 는 것 이 효율 적 이 ㄴ 것 같 아 염	<P>
이렇 게 늦 게 배송 하 시 ㄹ 거 이 면 연락 주 시 어요	<N>
배송 은 며칠 걸리 었 지만 배송 기사 님 들 설치 와 설명 을 정말 친절 하 게 하 아 주 시 었 고 요	<P>
그냥 매장 가 아서 살 는 것 이 나 을 거 같 네요	<N>
무진장 잘 돌 아 가 네	<P>
배송 이 너무 늦 어 홧김 에 취소 하 려고 하 다 기다리 었 는데 설치 기사 님 이 너무 친절 하 아서 잘 한 것 같 아요	<N>
감사 하 ㅂ니다	<P>
배송 이 너무 늦 어서 답답 하 았 습니다	<N>
헤헤	<P>
하지만 상품 은 정말 좋 군요	<N>
디자인 두 이뿌구	<P>
배송 이 너무 늦 어서 짜증 나 았 었 음	<N>
믿 어 보 시 어요	<P>
배송 이 너무 늦 어요	<N>
친절히 잘 갖 다 주 시 어서 잘 쓰 고 있 습니다	<P>
하지만 배송 기사 분 너무 친절 하 시 어요	<N>
감사 하 아요	<P>
배송 이 너무 늦 었 어요	<N>
결론 적 으로 극강추 상품 이 ㅂ니다	<P>
구매 다음날 배송 되 었 습니다 이 라는 문자 보내 어 놓 고는 전산 상 의 문제 이 라고 어쩌 ㄹ 수 없 다고 하 고	<N>
배송 품질 가격 어느 하나 이 라도 나무라 ㄹ 것 이 아무것 도 없 습니다	<P>
배송 준비 중 이 라는 단계 가 있 음 에 도 불구 하 고 그리고 품절 상태 이 라 생산 이 오래 걸리 ㅁ 에 도 불구 하 고 그런 말 한마디 도 없 었 는데	<N>
배송 되 ㄴ 그날 세탁기 돌리 었 는데 소리 도 조용 하 구 아주 만족 이 ㅂ니다	<P>
직배 송 상품 이 라 오래 걸리 ㄴ다고 하 고 늦 게 배송 되 ㄹ 수 도 있 다고 하 는 메세지 못 보 시 었 냐 그러 고	<N>
지정일 에 오 시 어서 설치 도 잘 하 아 주 시 었 구요	<P>
너무 불 친절 하 ㄴ 전화 응대 하 았 어요	<N>
디자인 도 괜찮 고 그냥 지르 시 어도 괜찮 을 듯 하 네 요	<P>
하지만 상품 은 잘 받 았 고	<N>
결혼 선물 하 아 주 었 는데 무척 좋아하 네 요	<P>
배송 이 너무 늦 은 거 같 애 요	<N>
예약 세제 섬유유연제함이 있 어 더욱 편리 하 겠 죠	<P>
품질 은 아직 사용 안 하 아 보 았 지만 좋 겠 죠	<N>
또 은 나 아 놀 아라 두 돌 되 ㄴ 울 딸 빨래 도 안심 하 며 하 ㄹ 수 있 어 좋 습니다	<P>
쌓 ㄴ 만큼 제품 도 좋 으면 좋 을 터 이 ㄴ데 좀 걱정 되 기 ㄴ 하 지만 믿 고 써야죠	<N>
후회 없 으시 시 ㄹ 것 이 ㅂ니다	<P>
배송 이 너무너무 늦 었 네요	<N>
아직 안 돌리 어 보 아서 모르 겠 지만 이불 빨래 도 거뜬 하 겠 어요	<P>
확실히 알 ㄹ 수 는 없 지만 안 되 ㄹ 거 같 아요	<N>
기사 분 들 도 넘 친절 하 시 고 만족 하 ㅂ니다	<P>
소음 좀 있 다는 건 알 았 는데 생각 보다 약간 소 음 이 강하 네 여	<N>
앞 으로 는 전화 꼭 받 아 주 시 고 좋 은 물건 저렴 하 ㄴ 가격 에 많이 판매 하 아 주 시 어요	<P>
세탁 실 따로 있 음 괜찮 을 꺼 같 은데 세탁 실 이 따로 없 다면 소음 때문 에 비 추 이 ㅂ니다	<N>
정말 맘 에 들 어요	<P>
가격 도 저렴 하 고 세탁기 는 깔끔 하 고 괜찮 네요	<N>
결론 적 으로 적극 추천 하 는 바 이 ㅂ니다	<P>
배송이 넘 오래 걸리 었 어요	<N>
경품 용 구입 으로 지정일 날짜 에 배송 요청 하 았 는데 원하 는 날짜 에 잘 배송 되 었 구요	<P>
하지만 설치 해주 신 기사 분 이 친절 하셔셔 괜찮 았 습니다	<N>
받 으시 ㄴ 분 도 많이 좋아하 시 네요	<P>
배송 이 느리 었 음	<N>
계속 쓰 어 보 아야 알 겠 지만 현재 로서 는 만족 하 ㅂ니다	<P>
배송 이 느리 군요	<N>
깔끔 하 고 가격 이 저렴 하 아서 걱정 하 았 는데 아주 좋 아 여	<P>
전화 이 라도 하 아 주 시 어서 대충 언제 오 시 ㄹ 것 이 ㄴ지 이 라도 말 하 아 주 시 면 안 되 는 것 이 ㄴ가요	<N>
싸 고 사용 편 도 좋 고 디자인 도 괜찮내여	<P>
세탁기 기다리 다 목 이 빠지 겠 군요	<N>
그리고 서비스 기사 편하 게 하 아 주 니 좋내여	<P>
주인집 할머니 댁 에서 내려오 아 세탁기 설치 하 는 것 이 ㄴ데 틀 제 할머니 도 대기 하 고 계시 는데 갈대 도 못 가 시 구요	<N>
고민 안 하 시 고 구매 하 시 어도 되 ㅂ니다	<P>
미리 연락 좀 주 시 죠	<N>
고맙 어요	<P>
제발연락처도 하나 도 없 구요	<N>
무엇 보다 친절 하 ㄴ 배송 과 설치 가 마음 에 들 었 습니다	<P>
배송이 느리단거 고 는	<N>
아주 멀 ㄴ 거리 도 출발 하 ㄹ 때 와 도착 하 ㄹ 때 확인 도 하 아 주 시 고	<P>
설치 하 아 주 시 는 분 도 친절하그 좋아욥	<N>
곧 결혼 하 는 신혼부부 선물 로 하 었 는데 너무 좋아하 네 요	<P>
배송이 늦 는다는 것 은 알 고 있 었 지만 설치 하 아 주 시 는 기사 분 이 너무 불 칠 전 하 고 사용 방법 을 알리 어 달래 았 더니 설명서 읽 어 보 면 되 ㄴ다는 말 한마디 하 고 가 네 요	<N>
공간 이 작 아 걱정 하 았 는데 우리 에게 딱 맞 는 세탁기 네 요	<P>
배송 이 늦 다고 쓰 어 있 어서 걱정 하 았 는데 의외로 빨리 오 네 요	<N>
공기방울 데 도 크 지 도 않 게 날렵 하 ㄴ 몸체 거기 다가 저 소음 으로 만족 하 ㄴ 빨래 를 오래간만 에 하 었 어요	<P>
배송 이 늦 어 참 속상 하 ㄴ 상품 일 이 ㅂ니다	<N>
스무스 하 게 잘 돌아가 더라구요	<P>
인터파크 도 문제 이 고 모두 가 문제 이 더군요	<N>
대우 세탁기 좋 아요	<P>
인터파크 이제 그만 이용 하렵니다	<N>
공기방울로 세탁 하 아 주 니 빨래 가 완전 말끔	<P>
너무 불편 하 고 고객 들 에서 넘 성의 가 없드군요	<N>
배송도 빠르 고 좋 아요	<P>
배송 되 었 는지 알아보 고 전화 하 아 주 ㄴ다는 아가씨 는 죽 었 는지 지금 까지 살 아 있 는지 는 모르 지만 말 이 ㅂ니다	<N>
착 한 가 격 에 하나 씩 들여가 시 어요	<P>
배송 이 늦 어서 너무 짜증 나 았 음	<N>
책 도 아니 ㄴ 데 하루 만 에 오 아서 놀래 었 어요	<P>
기다리 라 기다리 라 짜증 나 고 질문 에 글 답변 도 없 음	<N>
쓰 ㄹ 만 하 ㅂ니다	<P>
배송 이 늦 어서 다소 짜증 이 나 았 지만 부모 님 이 만족 하 아 하 시 네요	<N>
괜찮 네요	<P>
그 다음 에 ㄴ 바로 일 사 처리 되 어서 잘 쓰 고 있 습니다	<N>
괜찮 네요	<P>
제품 은 맘 에 들 ㅂ니다	<N>
깔끔 하 고요	<P>
선풍기 는 오 안주시 는 건징	<N>
괜찮 네요	<P>
배송 이 늦 어 지 어서 취소 요청 하 아 놓 았 다가 오늘 수령 하 았 습니다	<N>
디자인 도 마음 에 들 고 설치 기사 분 도 친절 하 시 구	<P>
물건 은 아주 좋 네요	<N>
자취 하 는데 귀찮 아서 새걸로 사 려고 하 었 는 대 쓰 어 보 았 는데 쓰 ㄹ 만 하 고 배송 도 빠르 네요	<P>
소음 이 좀 심하 네 요	<N>
괜찮 네요	<P>
밤 에 는 이웃 에게 폐 를	<N>
괜찮 네요	<P>
그래도 아주 쌓 ㄴ 가격 에 저 처럼 자취 하 시 는 분 들 는 딱 이 ㄴ 제품 이 듯 싶 습니다	<N>
생각 보다 크기 도 작고 혼자 사 는 저 에게 ㄴ 딱 맞 네 요	<P>
모터 소리 는 좀 시끄럽 ㄴ 것 같 네요	<N>
괜찮 네요	<P>
그래두 이 가격 에 혼자 사 는 데 괜찮 아요	<N>
다른 데 에 비하 아서 이 게 가격 도 제일 싸 던데 쓰 ㄹ 만 하 아요	<P>
근 데 세탁 하 ㄹ 때 조금 씩 움직이 어요	<N>
괜찮 네요	<P>
배송 이 빠르 네요	<N>
괜찮 습니다	<P>
밑 부분 나사 가 빠지 었 다던데 우리 누님 이 직접 끼우셧다던데그런 아쉬움 이 남 네 요	<N>
괜찮 아	<P>
배송 이 빨리 되 어서 좋 네요	<N>
괜찮 아요	<P>
오 아서 기존 세탁기 철거 하 아 가 고 설치 도 깔끔히 하 아 주 시 어서 좋 습니다	<N>
괜찮 아요	<P>
물류 센터 아저씨 의 친절 함 에 조금 누그러집니다	<N>
세탁기 도 생각 보 단 괜찮 습니다	<P>
배송이 생각 보다 많이 늦 게 이루 어 지 어서 기다리 는데 상당 하 ㄴ 인내 를 요구 하 았 다	<N>
가격 비교 만 잘 하 시 면 괜찮 습니다	<P>
배송 이 빨리 이루어지 는 소비자 도 있 을 수 있 겠 지만 휴일 을 포함 하 아 일 이상 은 주문 을 망설이 게 하 ㄴ다	<N>
소음 이 없 구요	<P>
제품 자체 는 기존 사용 하 던 제품 이 통 돌 이 라 그러 ㄴ지 크 게 눈여기 어 보 ㄴ 부분 이 라면 아무래도 세탁 시 의 소음 과 진동 에 민감 하 게 반응 하 게 되 ㄴ다	<N>
가격 대비 훌륭 하 아요	<P>
생각 보다 날카롭 ㄴ 음색 의 소리 가 좀 나 는 편 이 기 ㄴ 하 ㅂ니다	<N>
배송 기사 분 이 너무 친절 하 아서 맘 에 들 어요	<P>
종합 적 으로 보 았 을 때 가격 대비 가치 가 매우 높 은 제품 이 라고 생각 하 ㅂ니다	<N>
괜찮 아요	<P>
받 자마자 세탁 을 해보 았 는데 듣 던 데 로 통 돌 이 보다 때 는 잘 안 빠지 네 요	<N>
괜찮 은 것 같 네요	<P>
그래도 그런 거 감안 하 고 주문 하 ㄴ 거 이 니 잘 쓰 겠 습니다	<N>
괜찮 은 것 같 아요	<P>
부모 님 집 에 있 는 대용량 드럼 보 단 소음 이 좀 심하 네 요	<N>
괜찮 은 녀석 하 나 만나 았 네 여	<P>
디자인 도 무난 하 고 적당 하 ㄴ 용량 으로 혼자 쓰기 에 만족스럽군요	<N>
가격 대비 품질 최강	<P>
기존 에 사용 하 던 짜리 세탁기 랑 같 은 용량 이 ㄴ데 사이즈 가 작 아 서 문제 가 있 는 것 ㄴ 아닌가 걱정 하 았 는데 그런 걱정 과 상관없이 빨래 도 왠만큼 들어가 고 빨래 도 잘 되 고 암튼 좋 아요	<N>
믿 고 지르 시 어도 괜찮 을 듯	<P>
그래도 저희 집 이 층 에 승강 기 가 없 는 곳 이 ㄴ데 기사 분 한 분 이 오 시 어서 설치 하 아 주 시 었 어요	<N>
괜찮 은 거 같 네요	<P>
디자인 수려 하 고 성능 좋 아요	<N>
이만한 가격 에 이만 하 ㄴ 품질 이 라면 완전 만족 하 ㅂ니다	<P>
물건 은 좋 아요	<N>
많이 파시 고용 부자 되 시 어요	<P>
배송이 정말 넘 느리 더라구 요	<N>
굉장히 친절 하 고 좋 아요	<P>
배송 빼 고 는 상품 은 맘 에 들 ㅂ니다	<N>
마음 에 들 었 어요	<P>
깔끔 하 고 가격 도 좋 네요	<N>
배송도 나름 빠르 고	<P>
물품 은 잘 받 았 으니 감사히 사용 하 겠 습니다	<N>
번창 하 시 어요	<P>
근데 예전 에 사용 하 던 것 보 다는 안 이 좀 작 네요	<N>
대우 이미지 별 루 이 라 서 그냥 싼맛 에 삿는데사용 결과 절대 후회 하 지 않 습니다	<P>
그래도 싸 ㄴ 가격 에 이 정도 이 면 만족 하 ㅂ니다	<N>
겉모습 두 훨낫구여	<P>
근대 세탁기 가 좀 소리 가 크 ㄴ 거 같 네요	<N>
제 가 사용 을 안 하 아서 잘 모르 지만 집사람 이 딴소리 하 지 않 는 거 보 니 잘 돌 아 가 나 보 네 여	<P>
그래도 가격 에 비하 아 만족 만족	<N>
추천	<P>
배송 이 좀 늦 구 소음 이 좀 크 네요	<N>
구매 신청 하 고 대략 배송 가능 일 을 묻 으니 확답 을 못 은근히 오래 걸리 ㄹ 거 이 라 우려 하 었 는데 생각 보다 빨리 배송 이 되 었 습니다	<P>
전반 적 으로 만족	<N>
가격 도 착 하 ㅂ니다	<P>
세탁기 는 좋 은 거 같 네요	<N>
거기 에다 무 이자 개월 할부 특정 카드	<P>
그것 말 고는 정말 좋 아요	<N>
독신자 들 이 쓰기 참 좋 네요	<P>
연락 도 잘 안 되 구요	<N>
사업 번창 하 시 어요	<P>
에 알아보 아서 어렵 게 하 었 네요	<N>
친절 하 ㄴ 서비스 도 감사 하 아요	<P>
세탁기 는 저렴 하 게 좋 은 상품 인 것 같 습니다	<N>
번창 하 시 어요	<P>
배송이 느리 ㄴ 것 이 단점 이 네요	<N>
다음 에 도 꼭 애용 할 께 요	<P>
물건 은 싸 고 괜찮 은데	<N>
기사 분 도 친절 하 시 었 고 빨래 도 잘 되 고 색상 도 환 하 아서 욕실 도 넓 어 보 여 좋 구	<P>
출고 하 ㄹ 때 테스트 하 느냐고 묻 을 쓰 어 보 ㄴ 것 이 ㄴ지	<N>
암튼 만족 만족 임돠	<P>
드럼통 안 에 물기 가 있 어서 좀 찜찜 하 었 어요	<N>
감사 하 ㅂ니다	<P>
그래도 저렴 하 고 좋 아서 구매 결정 하 ㅂ니다	<N>
기사 님 이 설치 잘 하 아 주 고 가시 었 구요	<P>
배송 이 지연 되 아도 연락 전 에 는 절대 사전 통보 안 하 구요	<N>
감사 하 ㅂ니다	<P>
문자 만 일주일 이 지나 아서 오 ㅂ니다	<N>
장모 님 이 너무 좋아하 시 는군	<P>
마냥 기다리 는 게 필수 이 ㄴ가 보 아요	<N>
사업 번창 하 시 어요	<P>
배송 이 쪼 매 늦 었 지만 뭐 그런대로	<N>
많 은 번창 있 으시 기 를 기원 하 ㅂ니다	<P>
한가지 단점 은 며칠써보고 상품 평 쓰 려고 하 었 는데 구입 하 ㄴ 곳 에서 구매 확정 하 라고 문자 오 고 전화 오 고 아가씨 가 너무 불 친절 하 네 요	<N>
망설이 지 말구 사시 길	<P>
배송 이 늦 기 ㄴ 하 았 는데 설치 도 친절 하 게 하 아 주 시 구 감사 하 아요	<N>
구입 후 번 정도 사용 하 아 보 았 는데 현재 로서 는 만족 하 ㅂ니다	<P>
배 송이 하 ㄴ 달 이 걸리 ㄴ 거 같 아요	<N>
사용법 이 간단 하 아서 좋 네요	<P>
업체 에서 는 계속 미루 고	<N>
하여간 좋 은 세탁기 싸 ㄴ 가격 에 쌓 ㄴ 거 같 아 맘 에 쏙 들 ㅂ니다	<P>
어쩌 ㄹ 수 없 는 것 ㄴ 알 지만 조금 시간 이 많이 걸리 었 네요	<N>
배송 늦 을 거 각오 하 고 기다리 었 는데 그래두 생각 보다 는 일찍 오 아서 좋 구요	<P>
아무튼 잘 살 ㄴ 거 같 아요	<N>
배송 기사 님 이 진짜 친절 하 시 네요	<P>
오 더니 문 이 좁 아서 안 들 어 가 ㄴ다고 해체 하 아서 들어가 고 다시 조립 하 아야 하 ㄴ다고 해체 팀 이 한 시간 안 에 오 ㄴ다더니 시간 만 에 오 아서 또 삼만 원 챙기 어 가 았 습니다	<N>
감사 감사	<P>
빈집 에 일부러 가 아서 하루 종일 기둘렸는데 진짜 짱났습니다	<N>
좋 아요 소음 도 없 구요	<P>
삼성 전자 직배 송 보 고 믿 었 다 성질 버리 었 네요	<N>
아주 잘 빨래 되 어요	<P>
배송일 지정 하 아서 받 을 수 있 어 일단 좋 았 구요	<N>
좋 으시 네요	<P>
배송 지연 으로 약 주 화물 연대 파업 으로 지연 밀리 ㄴ 빨레 하 느라고 틀 간 계속 돌림	<N>
색상 도 좋 아요	<P>
근데 배달 아저씨 들 좀 안 좋 았 어요	<N>
세탁력 도 우수 하 구요	<P>
오 시 었 을 때 연결 만 좀 깔끔 하 게 하 아 주 시 었 으면 정말 너무 좋 았 을 터 이 ㄴ데 그 점 이 아쉽 어요	<N>
가격 도 좋 구요	<P>
그 외 에 물건 은 너무 좋 아요	<N>
굳굳굳	<P>
봉 이 있 다니 이렇 ㄹ 수 가	<N>
새해 복 많 이 받 으시 시 어요	<P>
정말 실망 이 었 습니다	<N>
저 는 대 만족 이 ㅂ니다	<P>
봉 이 있 었 다니	<N>
굳이 이 었 습니다	<P>
오 저런 봉 이 있 을 줄 이 야	<N>
가격 에 비하 아 아주 좋앗어요	<P>
부모 님 께 보내 어 드리 었 는데 기본 배송일 에 운송 파업 때문 에 너무 오래 걸리 었 네요	<N>
너무 이쁜 세탁기 잘 쓰 ㄹ께 용	<P>
그래도 만족 하 ㅂ니다	<N>
굳입니다용	<P>
기존 에 사용 하 던 세탁기 보다 외형 도 작고 그래서 그렇 ㄴ지 통 도 작 아 보이 신 다 구 요	<N>
굿	<P>
그렇지만 이런 가격 에 세탁기 를 어디 가 아서 사 겠 습니까	<N>
굿	<P>
비 와 여타 이유 로 배송 이 많이 늦 었 네	<N>
괜찮 네요	<P>
빨래 는 많이 해보 아야 좋 은지 알 수 있 겠 지만 일단 크 어서 좋 습니다	<N>
사이즈 도 아담 무게 도 가볍 고요	<P>
드럼 을 쓰 다가 통 돌 이 는 위 에서 세탁물 을 꺼내 려니 팔 이 애 를 쓰 는 게 좀 안쓰러럽네요	<N>
그럭저럭 좋 네요	<P>
한가지 흠 이 라면 게시판 에 전혀 응대 를 하 시 지 않 는다는 것 이 었 습니다	<N>
굿	<P>
게시판 에 저 뿐 만 아니 라 다른 많 은 분 들 이 글 을 남기 시 었 는데 단 한 개 의 댓글 도 달 지 않 으시 는 과감 하 ㅁ 이 돋보이 시 네요	<N>
굿	<P>
배 송전 연락 을 주 시 었 으면 하 는 아쉬움 이 남 습니다	<N>
굿	<P>
배송 기사 님 이 수평 만 이 라도 잡 아 주 고 가시 었 으면 하 었 는데 배송만 하 고 그냥 가 시 어 설치 하 고 수평 보 느라 애 먹 었 습니다	<N>
세탁기 가 돌 는 줄 모르 ㄹ 정도 로 조용 하 아요	<P>
빠르 ㄴ 배송 감사 드리 고 여	<N>
그리고 설치 기사 님 바지 를 접 어 올리 시 고 열심히 설치 하 아 주 시 는 모습 이 인상 적 이 었 어요	<P>
그러나 다른 정말 아니 ㄴ 것 같 습니다	<N>
부자 되 시 어요	<P>
다른 세탁기 에비 하 아 분명 작 아서 겨울 이불 을 빨 수 있 을까 의문 이 들 네 요	<N>
굿	<P>
빨래 돌리 어 보 았 는데 때 도 잘 빠지 고 탈수 도 잘 되 고 좋아욘	<N>
배송도 빠르 고 미리 연락 도 주 시 고 판매자 두 친절 하 고 두말 하 ㄹ 나위 가 없 네요	<P>
이불 이 들어가 지 않 아서	<N>
세탁기 는 트롬인데 디자인 도 아주 맘 에 들 ㅂ니다	<P>
그래도 후회 는 없 네요	<N>
굿 이 ㅂ니다	<P>
빨래 도 잘 되 고	<N>
굿뜨	<P>
탈 수 때 소음 은 조금 심하 아요	<N>
굿 이 에요	<P>
그치만그건감수해도괜찬은거같아요	<N>
굿 이 요	<P>
빨래 를 하 다 보 니 너무 엉킴이 심하 ㄴ 것 같 아요	<N>
괜찮 네요	<P>
물 높이 도 끝 까지 많이 받 아도 빨래 가 깨끗 하 게 헹궈지지 않 아서 여러번 반복 을 하 아야만 하 아요	<N>
굿 이 ㅂ니다	<P>
빨래 를 하 더라도 더 깨끗 하 ㄴ 것 같 아 좋 네요	<N>
굿	<P>
사은품땜에 사 았 는데 너무 하 네	<N>
귀사 의 무궁 하 ㄴ 발전 을 진심 으로 기원 하 ㅂ니다	<P>
세탁기 설치 도 별루 이 고 빨리 사은품 보내 시 어요	<N>
갓난아이 부터 초등학생 까지 명의 자녀 가 있 어 하루 에 몇 번 씩 빨래 를 하 아야 되 는데 낮 은 가격 에 신속 하 ㄴ 배송 까지 하 아 주 시 니 고객 감동 을 넘 어서 고객흥분이네요	<P>
빨리 잘 오 았 습니다	<N>
예쁘 어서 맘 에 들 어요	<P>
뽑 기 가 잘못 되 었 는지 후판 이 찌그러지 ㄴ 제품 이 배송 되 었 습니다	<N>
그냥 막 쓰 기에 좋 습니다	<P>
물론 교환 은 하 았 지만 처음 배송자 가 너무 쉽 게 그렇 ㄹ 수 있 다고 하 면서 그냥 설치 를 막 하 더라구요	<N>
그냥 모니터 상 으로 보 고 선택 하 려니 잘 모르 겠 던데 실제 배송 받 고 보 니 너무 이쁘 고 좋 더라구요	<P>
벗 교환 요청 하 아서 다시 받 았 습니다	<N>
아주 만족 하 ㅂ니다	<P>
다 들 잘 살피 어 보 시 고 배송 기사 님 연락 오 면 박스그대로 개봉 하 지 말 고 배달 하 아 달 라고 부탁 하 시 ㅂ시오	<N>
일반 세탁기 가격 에 더 뽀 대 나 는 드럼 을 쓰 고 세제 도 적 게 쓰 고 빨래 도 잘 되 고 전기 물 도 적 게 들 고 이런 가격 에 드럼 세탁 기 치 고는 매우 만족 하 ㅂ니다	<P>
교환 받 았 으니 배송 빼 고 제품 에 대하 아서 얘기 하 면 생각 보다 좀 시끄럽 ㄴ 거 같 습니다	<N>
배송 은 굉장 치 친절 하구 요	<P>
음 그래 이 고 생각 보다 빨래 가 적 게 들어가 네 요	<N>
그동안 년 동안 쓰 어 오 던 세탁기 을 이번 에 바꾸 면서 많이 알아보 아 신중 하 게 구매 하 게 되 었 는데 드럼 보 다는 좋 다고 하 네 요	<P>
그리고 그냥 세탁기 보다 드럼 세탁 시간 이 오래 걸리 더군요	<N>
잘 살 ㄴ 거 같에요	<P>
사람 아기 낳 는다고 빨리 보내 어 달 라 하 었 는데 기일 이 늦 은 것 ㄴ 그나마 이해 가 가지 만 배 송 상 문제 일수 있 으니 이해 를 하 ㄴ다 하 아도 아기 낳 으러 가 아서 아프 아 죽 겠 는데 전화 자꾸 오 아서 뭐 옥션처럼瑛릿?인터넷 들어가 아서 누르 라 말 라	<N>
그동안 대우 제품 을 년 가량 사용 하 다가 고장 이 나서 어 바꾸 게 되 었 는데 가격 대비 괜찮 은 것 같 아요	<P>
사람 짜증 나 도 그냥 알 겠 다 하 고 끊 었 는데 그다음 이틀 도 안 되 어서 사람 겨우 일어나 아서 움직이 고 밥 도 못 먹 고 산 모 몸 으로 힘들 어 죽 는데 또 전화 하 고	<N>
멀 지 너무 조용 하 고 편하 다고 하 ㄴ다	<P>
좀 쉬 려고 하 면 또 전화 하 고	<N>
우리집 이 설치 하 기 힘들 ㄴ 구조 이 ㄴ데 친절 하 게 배송 하 아서 설치 하 아 주 시 ㄴ 기사 님 들 께 도 감사 드리 어요	<P>
고객 이 언제 하 든 좀 내 어 버리 ㄹ 수 없 습니까	<N>
그동안 오래되 ㄴ 세탁기 를 사용 하 았 는데 이번거는 넘넘 좋 은 거 있 죠	<P>
사람 스트레스 받 아 죽 게 하 ㄹ 작정 이 ㅂ니까	<N>
빨래 도 구김 없이 넘 잘 되 고요	<P>
돈 을 지불 안 하 ㄴ 것 도 아니 고 돈 떼 먹 는 것 도 아니 ㄴ 데 그 자꾸 전화 와 서 무슨 짓 이 ㅂ니까	<N>
완전 오	<P>
어이 가 없 네요	<N>
설치 도 잘 하 아 주 시 어서 정말 감사 드리 ㅂ니다	<P>
엄청 실망 이 ㅂ니다	<N>
제 가 직접 사용 하 는 것 은 아니 구 어머님 이 사용 하 시 는 거 이 라 저 는 잘 모르 겠 지만 어머님 이 만족 해 하 시 네 여	<P>
다음 부터 대우 제품 무섭 어서 쓰 겠 습니까	<N>
감사 하 ㅂ니다	<P>
결론 반품 하 고 다소 비싸 더라도 다르 ㄴ 제 품 을 사 고 싶 다	<N>
우리집 에 오 자마자 온 집안 잡동사니 까지 다 하 아 보 았 는데 너무 좋 으시 네요	<P>
소음 제품 구입 이 정말 후회 되 ㄴ다	<N>
고민 하 시 는 분 에게 강추하고프네요	<P>
통 돌 아 가 는 소리 는 크 어 도 참 을 수 있 다	<N>
그래도 쓰기 괜찮 은 것 같 아요	<P>
통 돌 아 가 는 소리 와 금속 소리 가 나 ㄴ다	<N>
그래도 이 정도 이 면 만족 하 ㅂ니다	<P>
이 금속 소리 는 치과 에서 나 는 소리 와 금속 이 마찰 되 는 소리 이 라고 표현 하 ㄹ 수 있 다	<N>
그래도 머 괜찮은거같구여	<P>
판매자 태도 금속 소리 마찰음 이 나서 어 설치 자 한테 물어보 니 센터 에 서비스 를 받 으라고 하 었 다	<N>
그리고 정확 하 게 말씀 하 시 ㄴ 시간 에 오 시 어서 는 친절 하 게 구가 전 철수 하 아 주 시 고 청소 도 도와주 시 고 자세 하 게 기능 설명 까지 하 아 주 시 었 어요	<P>
그래서 서비스 를 받 은 결과 원래 이 제품 은 소리 가 엄청크다고 하 었 다	<N>
제 가 잘 모르 아서 이것저것 묻 었 는데 바쁘 시 ㄹ 터 이 ㄴ데 도 잘 설명 하 아 주 시 어서 좋 았 습니다	<P>
그래서 판매처 에 다시 전화 를 하 었 다 반품 하 고 비싸 더라도 다른 제품 으로 구입 하 기 위 하 여 그래서 담당자 한테 전화 하 었 더니 하 는 말 소리 가 크 더라도 센타 에서 불량 이 라는 결재 가 나 아야지 바꾸 어 주 ㄹ 수 있 다 그전 에 는 절대 안 되 ㄴ다 자르 아 차갑 게 말 을 하 었 다	<N>
그리고 제품 은 지금 까지 쓰 어 보 ㄴ 결과 지금 까지 보 ㄴ 어떤 세탁기 보다 기능 도 좋 고 세탁 도 잘 되 고 마음 에 들 었 습니다	<P>
정말 한번 팔 면 되 ㄴ다는 태도 이 다	<N>
저 에게 지름 신 을 내리 게 하 아 주 시 ㄴ 앞 구매자 분 들 감사 하 ㅂ니다	<P>
사실 은 본 제품 을 다른 판매자 한테 주문 하 았었 죠	<N>
장마철 에 보송보송 하 게 탈수 가 잘 되 어 좋 고 소리 도 크 지 않 아 좋 습니다	<P>
언제 쯤 배송 가능 하 냐 묻 었 더니 지금 은 알 수 없 고 월달되 보 아야 안 단 다	<N>
가격 대비 디자인 도 깔끔 하 고 빨래 도 잘 되 ㅂ니다	<P>
대충 언 제 냐 이 니까 그것 도 월 중순 이 되 보 아야 안 단 다	<N>
배송 이 늦 다고 하 아서 걱정 하 았 는데 생각 보다 빠르 더라고 요	<P>
오 아 미치겠돼	<N>
설치 하 시 는 기사 님 도 친절 하 고요	<P>
그리고 보 ㄴ 판매자 에게 전화 로 동일 모델 을 지금 주문 하 면 언 제 올 수 있냐니까빠르면 모래 쯤 늦 어도 월요일 도착 가능 하단 다	<N>
아무튼 여러 가지 로 좋 습니다	<P>
사용 잘 하 고 있 어요	<N>
비싸 ㄴ 것 사 지 마시 고 이 제품 사서 잘 쓰 시 어요	<P>
이 상품 은 저가 품 으로 만들 어 판매 하 기 때문 에 소음 이 나 도 정상 이 라며 그냥 가드 군	<N>
계속 웃음 잃 지 않 으시 고 즐겁 게 일 하 시 는 모습 이 보 기 좋 았 고 친절 하 ㅁ 에 감사 드리 ㅂ니다	<P>
소비자 를 우롱 하 기 위 하 여 만들 ㄴ 제 품 안 사 아야 되 ㅂ니다	<N>
암튼 드럼 세탁 기 사 려다가 이거 사 드리 고 돈 도 굳 고 크 게 효도 하 ㄴ 것 같 아 기분 좋 습니다	<P>
사용 하 ㄴ지 는 아직 한번 밖에 안 하 아 보 았 지만 화장실 에 놓 았 는데 원룸 문 열 어 놓 고 돌리 어도 소음 이 크 지 않 더라구요	<N>
가격 대비 만족 하 고 배송 하 시 는 분 들 도 너무 친절 하 시 어요	<P>
배송 은 토요일 날 만취 로 인하 아 다음날 한 밤중 이 었 던 오전 시 반 에 배송 하 ㄴ다고 전화 가 걸리 어 오 았 던 관계 로 점 감점	<N>
금방 세탁 을 해보 니 전 에 쓰 던 고가 에 하우젠 별 차이 를 못 느끼 겠 고 오히려 편리 하 ㄴ 기능 이 하 나 더 있 어 이 가격 에 이런 세탁기 를 사용 하 ㄹ 수 있 다는 게 고맙 ㄹ 따름 이 ㅂ니다	<P>
짜 리라 서 조금 벅차 ㄴ가 보 ㅂ니다	<N>
금액 대비 성능 에 정말 만족 하 ㅂ니다	<P>
어쨌든 맘 에 들 ㅂ니다	<N>
조용 하 고 편리 하 네 요	<P>
삼성 브랜드 믿 구 사 았 는 데 안 에 스테인리스 통 이 ㄴ데 도 삶 는 빨래 를 돌리 면 플라스틱 이 달구 어 지 ㄹ 때 나 는 누 린 내 가 나서 어 불안 하 ㅂ니다	<N>
설치 하 아 주 시 ㄴ 기사 님 도 친절 하 았 습니다	<P>
헹구 ㅁ 이 충분히 되 고 있 는지 도 약간 의심 스럽 구	<N>
세탁 도 크 ㄴ 문제 없이 잘 되 네 요	<P>
그럭저럭 적응 이 되갑니다	<N>
금요일 에 옥션 에서 주문 을 하 었 는데 월요일 에 배송 이 되 다니 엄청나 게 빠르 ㄴ 배송 감사 하 아요	<P>
삼성 세탁기 는 언제나 믿음직 스럽 ㄴ 것 같 아요	<N>
앞 으로 도 더 좋 은 서비스 를 부탁 드리 ㅂ니다	<P>
단점 일 의 배송기 간 끝	<N>
요즘 같이 불경기 에 장사 하 시 느라 고생 이 많 으시 네요	<P>
사용 하 아 보 니 좋 습니다	<N>
기사 님 도 무척 친절 하 시 고 제품 도 좋 습니다	<P>
엘지껏도 고려 는 하 었 지만 키 로 나 키로 나 키 로 나 통 크기 가 거의 똑같 은 것 을 확인 하 고서 왠지 상술 같 다는 느낌 이 들 더군요	<N>
잘 살 ㄴ 거 같 아요	<P>
상당히 오래 걸리 었 습니다	<N>
제품 또한 그리 크 지 b아 좋 았 구요	<P>
상태 도 좋 고 배달 하 시 는 분 들 이 친절 하 아서 더욱 좋 았 습니다	<N>
작동 도 시원 시원히 잘 되 는군 요	<P>
배송 당일 오전 이르 ㄴ 시간 에 그것 도 아주 이르 ㄴ 시간 에 전날 늦 게 까지 일 하 아서 곤하 게 자 고 있 는데 배송 기사 님 부지런 하 시 게 도 아주 일찍 전화 하 시 었 더군 요	<N>
좋 은 제품 을 산거 같 아 기분 좋 습니다	<P>
더 그런 건 담 날 꼭 두 새벽 에 배송 이 완료 되 었 음 을 알리 어 드리 ㅂ니다 이용 하 아 주 시 어서 감사 하 ㅂ니다 이 라는 문자 가 오 았 더군 요	<N>
한 번 돌리 어 보 았 는데 물살 이 그리 세 ㄴ지 는 모르 겠 는데 탈수 는 정말 잘 되 던 데 이 요	<P>
무엇 을 하 자는 것 이 ㄴ지	<N>
아저씨 들 도 친절 하 시 고	<P>
이것 서비스 이 라고 전화 나 문자 하 는 거 이 라면 안 하 는 것 이 더 나 을 듯	<N>
기능 도 많 고 정말 좋 은 것 같 아요	<P>
그런 거 제외 하고 는 상품 의 품질 이나 가격 모두 만족 하 ㅂ니다	<N>
기능 도 왠만한건 다 있 고 가격 에 비하 아 넘 좋 아요	<P>
상품 받 아 보 고 좀 실망 이 네요	<N>
기능 은 가격 에 바 하 아 좋 다	<P>
너무 작 아 아주 작 은 이불 외 에 는 세탁 이 불 가능 하 고 세탁 을 해보 니 소음 이 너무 심하 네 요	<N>
다른 삼성 보다 좋 고 기능 도 우월 하 아 보이 ㄴ다	<P>
특히 탈수 하 ㄹ 때 는 무슨 쇠 갈리 는 소리 까지 나서 어 너무 시끄럽 아 베란다 에 문 을 열 어 놓 을 수 가 없 네요	<N>
설치 하 아 주 시 는 분 도 친절 하 았 구	<P>
이웃 사람 한테 패 는 되 지 않 을까 걱정 이 ㅂ니다	<N>
세탁 도 잘 되 구	<P>
상품 받 아 보 니 생각 보다 는 작 기 ㄴ 하 았 지만	<N>
저 소음 이 라 또한 만족 하구 요	<P>
배송도 친절 하 게 잘 하 아 주 시 고 만족 하 ㅂ니다	<N>
가격 은 물론 저 렴 함 의 끝 이 구요	<P>
암튼 예쁘 구 맘 에 들 었 어요	<N>
설치 아저씨 도 넘넘 친절 하 시 네요	<P>
창고 에 있 었 다고 옆 에 때 가 글 구 페인트 가 살짝	<N>
좋 은 제 품 잘 구매 하 ㄴ 것 같 아요	<P>
상품 설치 이 며 서비스 도 만족 하 ㅂ니다	<N>
설치 아저씨 의 전화목 소리 가 어찌나 친절 하 ㄴ지 기분 이 더욱 좋 았 습니다	<P>
상품 은 괜찮 은 것 같 은데 배송 이 상당히 오래 걸리 네 요	<N>
기대 대 요	<P>
기다리 다 지치 어 죽 는 줄 알 았 네	<N>
쓰 기 에 도 딱 이 고 요	<P>
상품 은 괜찮 은데 배송 이 너무 늦 어요	<N>
배송 하 시 느라 수고 진짜 많 으시 었 습니다	<P>
배송 서비스 개선 이 요망 되 ㅂ니다	<N>
좋 은 가격 좋 은 물건 많이 파시 길	<P>
상품 은 너무 괜찮 은 것 같 아요	<N>
기대 하 았 던 것 만큼 좋 습니다	<P>
상품 은 마음 에 들 는데 배송 기간 이 역시 나 많이 느리 더군요	<N>
배송도 빠르고요친절하신써비스 만족 하 ㅂ니다	<P>
어쩐지 배송 언제 되 는지 문의 사항 이 많 더라고 요	<N>
모양 도 이쁘 고요	<P>
그래도 세탁기 만 보 면 마음 에 들 ㅂ니다	<N>
기사 분 들 친절 하 시 고 제품 도 좋 아요	<P>
상품 은 만족 하 나 배송 에서 진짜 열 받 네 요	<N>
아직 쓰 어 보 지 ㄴ 않 았 지만 좋 아 보이 어요	<P>
아사리 매장 가 아서 쌀 것 그렇 네요	<N>
기사 가 직접 오 아서 설치 하 아 주 시 고 세탁기 좋 네요	<P>
짜증 이 빠 이 ㅂ니다	<N>
흰색 이 고 자리 차지 도 많이 하 지 않 고 잘 빨 아 지 네 요	<P>
상품 은 물론 만족 이 구요	<N>
기사 이 니 들 도 친절 하구 세탁 기도 잘 돌 아 가구	<P>
긍데 배송이 넘 늦 어서	<N>
너무 좋 네요	<P>
거의 열흘걸렸어여	<N>
기사 님 층 까지 올리 시 ㄴ다고 수고하셧구요	<P>
다만 아쉽 ㄴ 점 이 있 다면 설치 기사 가 엘지 옷 입 고 오 아서 인지 몰 라 도 설명 도 별로 없 고 수평 도 어떻 게 맞추 는지 알리 어 주 지 도 않 고 그냥 가 네 요	<N>
기사 님 너무 친절 하 고 너무 세심 하 게 가르치 어 주 시 고 너무 감사 하 ㅂ니다	<P>
수평 이랑 위치 및 설치 도 제 취향 에 맞추 어서 다시 설치 하 았 습니다	<N>
기사 님 완전 친절 하 시 어서 기분 이 좋 네요	<P>
헐	<N>
설치 환경 이 열악 하 시 ㅁ 에 도 불구 하 고 땀 뻘뻘 흘리 시 면서 돕 아 드리 겠 다고 하 아도 궂 이 혼자 하 시 는 것 이 편하 시 다며	<P>
근데 무려 제품 주문 하 고 받 아 보 기 까지 가 보름 이 걸리 었 네요	<N>
드럼 잘 안빨린다고 걱정 하 았었 는데 세탁 잘 되 구요	<P>
처음 부터 이 정도 시간 이 소요 되 ㄴ다고 말씀 하 아 주 시 었 음 마냥 기다리 지 않 았 을 터 이 ㄴ데	<N>
기사 님 친절 하 고 자기 집 처럼 정리 하 아 주 고 가 더군요	<P>
아무런 말 이 없 어서 마냥 기다리 다 어찌나 화가 나 던 지 요	<N>
세탁기 많 이 파 고 부자 되 시 어요	<P>
그래도 일주일 넘 어서 게시판 에 문의 하 니깐 전화연락주시더군요	<N>
세탁기 이 라면 대우 클라쎄 가 좋 아요	<P>
상품 은 좋 으나 배송 이 너무 느리 어 요	<N>
기사 님 친절 하 시 었 어요	<P>
마침 세탁기 가 고장 나 아서 제품 이 라 너무 저렴 하 기 도 해서 주문 하 았 는데 배송 이 느리 어서 손 세탁 하 느라 삐질삐질	<N>
기사 님 친절 하 시 고 제품 가격 도 저렴 하 ㅂ니다	<P>
상품은잘받읏음다	<N>
기사 님 도 너무 친 철 하 시 고 제가 구매 확정 을 너무 늦게?네요	<P>
두껍 ㄴ 이 불 은 안들어가겟어여	<N>
고맙 습니다	<P>
커텐 이랑 티몇개 넣으니까꽉차네여	<N>
기사 님 도 좋고배송도 무척 빠르 고 이전 에 쓰 던 삼성 과 는 다르 게 마지막 헹구 ㅁ 전 에 소리 가 나서 어 아주 좋 아요	<P>
싼가격에사긴햇는데흠솔직히하게제품설명해주셧으면조켓네여	<N>
기사 님 도 좋 으시 고 가격 도 싸 게 사 아서 만족 스럽 네 요	<P>
상품 을 일 만 에 받 았 어요	<N>
기사 님 도 친절 하 구요	<P>
배송 때문 에 디엔샵 고객 센터 에 전화 를 하 았 는데도 담당자 분 이 신경써 주 시 지 않 아서 기분 이 나쁘 았 지만	<N>
저렴 하 지만 무엇 보다 도 세심 하 ㄴ 배려 가 돋보이 네 요	<P>
암튼 물건 을 받 아 보 니까 가격 대비 완전 만족 이 ㅂ니다	<N>
저렴 하 지만 무엇 보다 도 세심 하 ㄴ 배려 가 돋보이 네 요	<P>
하지만 배송 이 너무 늦 게 되 ㄴ 것 은 업체 에서 올바르 게 공지 를 하 아야 하 았 다고 생각 이 되 ㅂ니다	<N>
기사 님 도 친절 하 시 고 상품 을 아주 잘 받 았 습니다	<P>
상품 이 배송 되 어 사용 하 아 보 니 생각 보다 품질 이 좋 아요	<N>
세탁기 도 잘 돌아가 고 깨끗 하 게 세탁 이 되 었 네요	<P>
마누리가 일주일 동안 밀리 ㄴ 빨레 손 으로 빨 다가 몸살 나 아서 현재 병원 다니 고 있 음	<N>
기사 님 도 친절 하 시 고 제품 도 깔끔 하 고 너무 좋 구요	<P>
급 하 신분 들 은 매장 이나 대리점 을 이용 하 시 ㅁ 이 좋 을 듯 싶 어요	<N>
만족 하 아요	<P>
가격 도 싸 고 좋 은데	<N>
기사 님 도 친절 하 시 고 제품 도 좋 아요	<P>
사진 에서 보 ㄴ 거 와 너무 도 다르 아 쌓 ㄴ 티 가 줄줄	<N>
기사 님 도 친절 하 시 고	<P>
용량 은 로 이 ㄴ데 기존 의 쓰 던 것 도 대우 외형 부터 눈 에 띄 게 작고 안 의 통 도 너무 너무 작 구	<N>
기사 님 도 친절 하 시 고 꼼꼼 하 게 설치 하 아 주 시 네요	<P>
크 ㄴ 이 불 은 들어가 ㄹ까 모르 ㄹ 정도	<N>
사용법 까지 설명 해 주시 고 요	<P>
한마디 로 실망 실 망 이 ㅂ니다	<N>
물건 보다 서비스 에 더 만족 하 ㅂ니다	<P>
너무 허접해보이네요	<N>
기사 님 도 친 철 하 고 뭐 물건 이야 좋 겠 죠	<P>
칼라 도 거의 하 얘 정말 고급 스럽 ㄴ 맛 이 하나 도 없 구요	<N>
기사 님 들 너무 친절 하 시 게 설치 하 아 주 시 고 깔끔 하 게 마무리 하 시 고 가 시 네요	<P>
대 실망	<N>
제품 도 괜찮 네요	<P>
후회막급 이 ㅂ니다	<N>
만족 하 ㅂ니다	<P>
살 시 는 분 들 신중히 결정 하 시 어요	<N>
기사 님 들 아침 일 찍 원하 는 시간 에 오셔셔 너무 친절 이 배송 하 아 주 시 었 구요	<P>
도착 하 자마자 세탁기 한번돌렸봤는데 역시 제가 기대 하 았 던 것 만큼 훨씬 못 미치 네 요	<N>
엄마 가 넘 좋아하 시 어요	<P>
사실 분 들 신중히 결정 하 시 고 판단 하 시 어요	<N>
빨래 넘 깨끗 하 게 잘되여	<P>
저 이거 반품 안 되 나요	<N>
삼성 세탁기 ? 오	<P>
상품 평 보 니까 다 들 소 음소 음 그러 던데 실제로 경험 하 아 보 니깐 최고 나 도 소 음소 음	<N>
처음 시키 어 보 는 거 이 라 걱정 많 이 하 았었 는데 꼼꼼 하 ㄴ 설명 정말 감사 하 ㅂ니다	<P>
나 ㄴ 무슨 헬리콥터 오 ㄴ 줄 알 았 네	<N>
수고 하 시 고 좋 은 하루 되 시 어요	<P>
그래도 배송 디자인 은 굿 굿	<N>
세탁 도 해보 았 는데 잘 되 네 요	<P>
자박자박 하 게 도 안 차 던데	<N>
기사 님 들 이 친절 하 고 성능 도 좋 습니다	<P>
암튼 만족 하 아요	<N>
기사 님 은 친절 하시 이 ㄴ데	<P>
저희 엄마 ㄴ 뭐 비교 대상 이 없 어서 그러 ㄴ지 소음 메 대하 아서 ㄴ 아무 말씀 안 하 시 었 지만요	<N>
여자 혼자 서 택배 받 기 겁 도 나 고 하 었 는데 두 분 이서 오 시 어서 신속 하 게 설치 하 아 주 시 고 가시 었 어요	<P>
무엇 이 세탁기 를 방 에 들여놓 고 쓰 는 것 도 아니 고 또 마침 친정집 에 따로 세탁 실 이 있 어 다행 이 기 ㄴ 하 았 지만 그래도 신제품 이 라는데 어쩌 어 소음 이 년 전 엘지 것 보다 크 ㄹ까 아쉬움 이 남 더라고 요	<N>
이틀 뒤 부터 사용 하 아 이 라고 하 시 어서 아직 사용 은 못 보 았 지만 일단 굉장히 마음 에 들 네 요	<P>
그것 만 빼 면 무난 하 ㄴ 제품 이 ㄴ 것 같 습니다	<N>
잘 사 았 다는 생각 이 들 ㅂ니다	<P>
근데 빨래 양 이 너무 적 으면 탈수 가 안 되 ㄴ다는 거	<N>
기사 님 이 너무 친절 하 시 어서 기분 이 매우 좋 았 어요	<P>
탈수 만 하 려고 했으나메뉴도 없 고 설명서 도 내용 이 없 어 전화 해 보고서 야 알 았 다는 거	<N>
설치 끝나 ㄴ 후 에 설치 끝나 았 다고 문자 도 해 주시 고 대 만족 이 ㅂ니다	<P>
그거 빼 고는 괜찮 은 거 같 아요	<N>
기사 님 이 너무 친절 하 시 었 습니다	<P>
아 헹굼기능이 무조건 두 번 이 라는 거 그것 이 좀	<N>
기사 님 이 엄청 친절 하 시 네요	<P>
전 에 쓰 던 세탁기 는 한번 만 돌아가 아서 헹굼제 까먹 으면 다시 헹구 ㅁ 만 한번 하 면 됐는데잊지 말 고 헹굼제를 제때 넣 어 주 어야 하 ㄴ답니다	<N>
세탁기 두 좋 구요	<P>
뭐 이것 빼놓 고는 다 괜찮 은 거 같 아요	<N>
기사 님 이 오 시 어서 설치 도 하 아 주 시 고 좋 았 어요	<P>
옥션 에서 중고 십만 원 에 구입했었는데후회스럽습니다	<N>
기사 님 이 참 친절 하 시 더군 요	<P>
노인 들 이 무척 들 어 하 아서 중고 이제 ㄴ 안삽니다	<N>
아무튼 좋 은 것 같 네요	<P>
대체 적 으로 깔끔 하 고 괜찮 습니다	<N>
기사 님 이 친절히 설명 도 하 아 주 시 고 설치 도 해 주시 고 일 찍 잘 받 은 거 같 애 요	<P>
단점 이 있 다면 세탁물 의 무게 가 무겁 면 흔들리 ㅁ 이 심하 다는 것	<N>
기사 님 이 사용법 하나하나 설명 해 주시 구 기분 좋 은 배송 에 세탁기 도 빨래 를 잘하네염	<P>
색 이 정말 근사 하 고도 너무 예쁘 어요	<N>
기사 분 친절 하 고 제품 도 좋 습니다	<P>
근데 작 은 듯 하 아요	<N>
대우 파이팅	<P>
생각 보다 늦 게 오 네 요	<N>
기사 분 께서 친절 하 게 설명 도 하 아 주 시 고 고맙 습니다	<P>
일반 세탁기 와 비슷하고여쾌속으로 하 면 일반 세탁 보다 빠르 ㄴ 시간 에 세탁 가능 하 네 여	<N>
강츄	<P>
생각 보다 빠르 ㄴ 배송 감사 하 았 구요	<N>
기사 분 께서 후다닥 설치 를 잘 하 아 주 시 면서 도 친절 하 게 설명 하 아 주 시 었 답니다	<P>
빨래 가 많 은 것 은 아니 니까 잘 쓰 ㄹ 수 있 겠 어요	<N>
기사 분 도 완전 친절 하 시 고 인간미 넘치 시 었 어요	<P>
생각 보다 엄청작아보이는뎅	<N>
기사 분 들 친절 하 시 고 만족 하 ㅂ니다	<P>
생각 보다 이쁜데요	<N>
만족 하 ㅂ니다	<P>
원룸 살 시 는 분 들 에게 ㄴ 좋 을 듯	<N>
배송도 빠르 고 좋 았 습니다	<P>
그래도 탄탄 하 고 잘 돌 아 가요	<N>
굿 굿 굿	<P>
과 의 차이 가 별로 없 을 줄 알 았 는데 저의 착각 이 었 습니다	<N>
기사 분 들 도 친절 하 구 세탁기 도 맘 에 들 고 잘 되 는 것 같 아 좋 아요	<P>
생각 보다 작 지 않 았 어요	<N>
기사 분 들 도 친절 하 시 고 소음 도 그리 크 지 않 고 좋 은 것 같 아요	<P>
크 ㄴ 이 불 빨래 는 힘들 듯	<N>
기사 분 이 잘 설치 하 아 주 시 었 어 여	<P>
하지만 가격 대비 성능 디자인 다 좋 습니다	<N>
기사 분 이 친절 하 게 설치 하 아 주 고 가시 었 어요	<P>
생각 보다 좋 네요	<N>
기사 분 이 친 철 하 고 조 아 요	<P>
암튼잘쓰고 있습니당	<N>
기사 아저씨 도 물건 도 최고 이 ㅂ니다	<P>
생각 보다 크 고 쓰 ㄹ 만 하 지만 다른 드럼 세탁 기 들 보다 확실히 소음 은 크 네요	<N>
첫 빨래 를 하 았 는데 깨끗 하 게 되 네 요	<P>
생각 보다 크기 가 되 게 작 네요	<N>
기사 아저씨 도 친절 하 고 넘넘 좋다네요	<P>
있 던 일반 세탁기 가 잇 었 는데 그것 보다 훨씬 작 아요	<N>
역시 홈쇼핑 에서 사 길 잘 하 ㄴ 것 같 아요	<P>
이불 빨래 가 가능 하 ㄹ까 는 좀 의문 스럽 기 ㄴ 하지만 다른 건 만족 하 아요	<N>
상품 비교 제일 싸 고 좋 은 것 같 네요	<P>
생각 보다 통 은 작 은 듯 하 아서 아무래도 이불 을 효과 적 으로 못빠는 기분 이 네요	<N>
기사 아저씨 도 친절 하 시 고 쌓 ㄴ 가격 에 구입 하 ㄹ 수 있 어 좋 아요	<P>
소음 은 원래 저희 집 이 세탁기 가 말썽 이 여 서 그러 ㄴ지 괜찮 네요	<N>
기사 아저씨 도 친 철 하 게 배달 잘 하 아 주 시 고 요	<P>
배송 이 느리 어 요	<N>
만족 하 아요	<P>
사면 흘 정도 넘 어야 도착 하 ㅂ니다	<N>
기사 아저씨 들 도 친절 하 시 고	<P>
생각 보다 는 소음 이 좀 심하 네 요	<N>
기숙사 에 중고 세탁 기 를 처분 하 고 이번 에 삼성 세탁기 로 교체 하 았 는데 직원 들 이 아주 좋 아라 하 ㅂ니다	<P>
전 에 트럼 을 사용 하 았었 는데 트럼 보다 는 조금 시끄럽 습니다	<N>
가격 도 착하 고 드럼 세탁 기 만큼 은 아니 겠 지만 세탁력 도 나무라 ㄴ데 없 고요	<P>
하지만 이 가격 에 이만한 상품 흔하 지 않 습니다	<N>
기숙사 에서 사용 하 ㄹ 것이라가격대비 만족 이 네요	<P>
생각 보 단 크기 가 작 아요	<N>
기숙사 에서 쓸거인디오늘 오 아서 이제 설치 하 고 아직 사용 을 안 하 아 보 아서 모르 겠 지만 세탁기 는 제 견해 로 대우 께 괘 안 터 이 라구 요	<P>
생각 보 단 별 로 일 이 ㅂ니다	<N>
감사 하 ㅂ니다	<P>
상품 평 에 ㄴ 다 들 좋 다고 하 아서 사 았 는데 세탁 탈수 시간 이 내 어 맘대로 조절 이 안 되 네 요	<N>
기사 분 이 친절 하 게 설치 하 아 주 시 었 다고 하 ㅂ니다	<P>
년 전 에 사 아서 여태 까지 쓰 다 버리 ㄴ 세탁 기만 못 하 네 요	<N>
덕분 에 사위 고맙 다는 소리 들 었 습니다	<P>
기대 가 너무 크 나요	<N>
세탁기 새로 오 ㄴ 기념 으로 받 자마자 빨래 를 하 었 는데 너무 잘 되 네 요	<P>
쌓 ㄴ 것 이 역시 비 지 떡	<N>
넘 좋 아요	<P>
그런데 택배 기사 님 황송 하 ㄹ 만큼 왕짱친절하셨답니다	<N>
기존 마트 가격 보다 저렴 하 고 배송도 생각 보다 빠르 네요	<P>
생각 하 았 던 것 보다 소음 이 조금 커 요	<N>
성능 도 무난 하 게 쓰 ㄹ 만 하 ㄴ 거 같 습니다	<P>
그것 빼 곤 배송도 친절 하고 대체 적 으로 괜찮 은 상품 이 ㄴ 듯	<N>
상기 제품 은 건조 기능 이 되 지 않 지만 그래도 만족 하 ㅂ니다	<P>
생각 하 았 던 것 보 다는 실망 이 ㅂ니다	<N>
좋 은 점 은 옷감 이 엉킴현상이 없 어서 좋 구요	<P>
소리 가 너무 많이 나 아요	<N>
감사 하 ㅂ니다	<P>
시끄럽 어서	<N>
기존 에 쓰 던 통 돌 이 에 비하 아 너무 조용 하 고 소음 이 없 어 일단 은 만족 하 ㅂ니다	<P>
그래도 발래는 깨끗 하 아서 다행 이 에요	<N>
아기 빨래 삶 는 거 는 아직 안 하 아 보 았 는데 나머지 는 좋 읍니다	<P>
서비스 면 에서 아주 실망 이 ㅂ니다	<N>
설치 하 아 주 시 ㄴ 기사 님 너무 친절히 잘 하 아 주 시 었 고 설명 도 잘 하 아 주 시 어서 좋 구요	<P>
물론 호스 의 길이 는 기본 형 이 라고 는 하 아도 물 빠지 는 구멍 에 딱 맞 게 금 호스 의 끝 부분 을 더 이 어서 붙이 어 주 는 것 이 브랜드 세탁기 의 기본 서비스 아니 던가 요	<N>
기존 에 쓰 던 거 에 비하 아 크기 가 좀 작 아 보이 지만 용량 이 같 으시 니깐 오히려 심플 하 니 더 보기 가 좋 네요	<P>
근데 요즘 경기 가 어렵 다고 대기업 본사 에서 참으로 야박 하 게 굴 는 모양 이 네요	<N>
색상 도 밝 아서 예쁘 어요	<P>
급하 면 천원 정도 들이 어서 개인 적 으로 사 다 끼우 고 아님 언제 공급 되 ㄴ지 도 모르 는 호스 를 마냥 기다리 라고 만 합디다	<N>
기존 에 쓰 던 게 고장 나 아서 엄마 사 드리 었 는 대 엄마 가 좋 다고 하 네 요	<P>
참 박 하 ㅂ니다	<N>
배송도 잘 하 아 주 시 었 어요	<P>
대 기 업 엘지 빨래 는 하 아야 되 겠 고 빨래 를 하 자니 짧 은 호스 가 배수 구멍 에 안 맞 아서 배 란 다 가 물 천지 가 되 는 지 이 라 직접 원 들이 어서 호스 를 끼우 어야 되 나 싶 지만 그래도 소비자 로서 이것 ㄴ 아니 죠	<N>
깔끔 하 고 간편 하 고 좋 군요	<P>
당연히 받 아야 하 ㄹ 서비스 를 받 지 못 매우 불쾌 하 ㅂ니다	<N>
가격 상품 모두 만족 하 ㅂ니다	<P>
얼마 안 되 는 금액 이 지만 참으로 불쾌 하 기 짝 이 없 습니다	<N>
깔끔 하 고 귀엽 어서 넘 크 다는 생각 이 안드에요	<P>
기본 적 이 ㄴ 소양 이 덜 되 ㄴ 엘지	<N>
소음 도 적 고 배송도 전화 하고 오 아서 설치 를 다 하 아 주 니 좋 네요	<P>
엘지 제품 이제 ㄴ 다시 는 구매 하 고 싶 지 않 네 요	<N>
깔끔 하 고 사용 하 기 편 하 네 요	<P>
서비스 센터 일 하 았 던 사람 말 로 는 인터넷 구매 하 는 것 과 하이마트 와 일반 가전제품 점 에서 구매 하 는 상품 이 다르 다 하 던데 그냥 보 기 에 는 똑같 고 좋 네요	<N>
서비스 도 좋 았 구요	<P>
좀 작 아 은 듯 싶 네 여	<N>
설치 도 하 아 주 어서 고맙 구요	<P>
이블 빨래 하 기 가 좀	<N>
구 모델 도 수거 하 아 주 어서 고맙 어요	<P>
서비스 가 좋 네요	<N>
깔끔 하 고 세탁 도 잘 되 구 좋 네요	<P>
배송이 조금 느리 네요	<N>
깔끔 하 고 세탁 도 조용히 잘 되 ㅂ니다	<P>
일주일 이상 걸리 네 요	<N>
깔끔 하 고 이쁘 네요	<P>
설치 장소 가 좁 아서 이 모델 로 알아보 았 는데 다른 데 는 배송 기간 이 좀 오래 걸리 더라구 요	<N>
맑은헹굼 기능 도 있 고 만족 하 ㅂ니다	<P>
일반 세탁기 용량 으로 는 정도 되 아라 나	<N>
깔끔 하 고 좋 네요	<P>
설치 하 시 는 두 분 모두 조금 은 미흡 하 시 ㄴ 것 같 더군요	<N>
배송 기사 분 두 친 절하 시 고 여	<P>
줄이 짤아 전 에 쓰 던 것 로 연결 하 아 쓰 는데 물 이 줄 줄 줄 새 지 않 게 하 아 달라 니까 철문 점 에 가 아서 줄 을 사 다가 하라 네 요	<N>
깔끔 하 니 크기 도 적당 하 고 좋 네요	<P>
첨 에 수도 연결 부분 을 대충 하 아서 물 이 새 는 바람 에 깜짝 놀래 었 어요	<N>
세탁기 돌리 어 보 았 는데 세탁 도 잘 되 고 괜찮 아요	<P>
바쁘 시 더라도 재 대로 하 아 주 시 었 음 두 번 오 시 ㄹ 일 이 없 는데	<N>
가격 도 마트 대비 너무 저렴 하 고 만족 하 ㅂ니다	<P>
암튼그점빼고는다좋아요	<N>
습기 많 은 장마철 에 미루 어 두 었 던 빨래 를 하 고 나 니 너무 상쾌 하 ㅂ니다	<P>
근데 생각 보다 크기 가 많이 작 네요	<N>
깔끔 하 ㄴ 디자인 에 착하 ㄴ 가격까지맘에 드 네 요	<P>
하 기 로 길 ㄴ 하지만 허리 밖에 안와 서 적잔히 당황 하 았 어요	<N>
세탁물 넣 는 입구 창 이 크 어서 편하 아요	<P>
하지만 일반 세탁기 를 쓰 다 드럼 을 쓰 려니 조금 불편	<N>
깔끔 하 ㄴ 외관 깨끗 하 ㄴ 세탁드럼세탁기와 고민 하 다 고르 ㄴ 제품 이 ㄴ데 제 선택 에 대하 아서 만족 하 ㅂ니다	<P>
일반 세탁 기 는 이면 이불 빨래 가능 하 지만 요거 는 이불 하 나 넣 으면 꽉 차 아요	<N>
공기방울 때문 이 지 더욱 깨끗 하 게 빨리 는 듯 하 ㄴ 느낌 이 구요	<P>
용량 은 조금 작 은 듯	<N>
무엇 보다 배송 설치 모두 빨리 하 아 주 시 어서 감사 하 ㅂ니다	<P>
그리고 탈수 할 때 무지 소리 가 크 ㅂ니다	<N>
깔끔 하 ㄴ 화이트 색 상 에 글 구 대우 가 저렴 하 아요	<P>
비행기 가 날아가 는 소리 가 나 아요	<N>
전자 제품 우연 차 ㄴ 것 이 대우 제품 이 만치 만 잔 고장 두 없 구 년 째 냉장고 두 잘 사용한 답 니 다	<P>
그래도 뭐 세탁기 가 빨래 깨끗히 잘 하 면 되 죠	<N>
굿 이 ㅂ니다	<P>
성능 은 꽤 괜찮 은 것 같 은데 정확 하 게 키로 짜리 는 아니 ㄴ 거 같 아요	<N>
같 은 데 전과 다르 게 부피 는 작아지 고 조용 하 아 지 ㄹ게 좋 네요	<P>
하지만 가격 대비 만족 하 ㅂ니다	<N>
배송 하 아 주 시 는 대우 직원 분 들 도 친절 하 시 구요	<P>
쩝	<N>
가격 도 맘 에 들 어요	<P>
상품 의 배송 기간 은 일 로 만족 스럽 지만	<N>
깜찍 하 고 이쁘 네요	<P>
세제 통 이 완전히 빠지 지 않 는 게 좀 불편 하 고	<N>
저렴 하 ㄴ 가격 에 강추합니다	<P>
세탁 시간 이 좀 길 고	<N>
깨끗 하 게 생기 ㄹ게 빨래 도 잘 대 네 요	<P>
소음적으며 폼 남	<N>
깨끗 하 게 세탁 되 어 속 이 시원 하 다	<P>
세탁 성능 좋 구요	<N>
디자인 도 심플 하 아서 좋 은 것 같 다	<P>
세탁기 고장 나 아서 살 는 사람 이 면 큰일 나 겠 네요	<N>
깨끗 하 고 성능 도 좋 네요	<P>
청소기 는 담 날 바로 오 았 는데 세탁기 는 일주일 이나 걸리 네 요	<N>
깨끗 하 ㄴ 세탁 과 조용 하 ㄴ 것 이 아주 맘 에 쏙 들 어요	<P>
다만 배송 이 좀 느리 어서 언제 쯤 도착할지연락이라도 하 아 주 지 고객 센터 에 전화 하 아서 야 알 았 네요	<N>
가격 은 상대 적 으로 넘 싸 고요	<P>
세탁기 고장 나 아서 엄청 고생 하 았 는데 일주일 정도 걸리 어 받 는 세탁기	<N>
강추예요	<P>
세탁기 기술 이 많이 발전 을 했느데 소음 은 조금 크 게 나느것 같 아요	<N>
예전 에 통 돌 이 쓰 었 는데 그 때 호수 연결관 이 위쪽 에 있 었 는데 지금 은 뒤 에 있 어 화장실 공간 을 조금 더 차지 하 는 것 빼 고는 괜찮 은 거 같 습니다	<P>
다른 모 들 ㄴ 점 은 정말 좋 아요	<N>
나름 괜찮 은 거 같 네 여	<P>
그래도 가격 이 착하 니까	<N>
가격 이 무엇 보다 너무 저렴 하 아서 좋 구요	<P>
세탁기 돌아가 는 소리 를 들 어 보 면 좀 착 가라앉 는 소리 보 다는 몸체 가 가볍 다고 생각 하 ㄹ 정도 의 소리 가 좀 나 더라구요	<N>
절대 후회 하 지 않 으시 시 ㄹ 제품 이 되 ㄹ 거 에 요	<P>
세탁기 사실 분 여기서 사지 마 세 요	<N>
생각 있 으시 ㄴ 분 들 은 망설이 지 말 고 구매 하 시 어요	<P>
돈 몇 천 원 더 주 시 더라도 차라리 다른 곳 에서 사 시 ㅂ시오	<N>
자주 이용 하 는 만큼 정말 판매자 괜찮 고요	<P>
가전제품 이 니까 배송 이 빨리 오 고 안 오 고는 솔직히 기대 도 안 하 았 습니다	<N>
그리고 서비스 도 잘 하 아 주 ㅂ니다	<P>
그런데 결제 하 고 난 바로 다음 날 물건 이 배송 되 었 습니다 이 라는 메일 받 았 는데 일정 도 걸리 어서 물건 오 더라구요	<N>
나름괜찮아서 추천 하 ㅂ니다	<P>
전 무슨 미국 에서 나르 아 오 는 줄 알 았 습니다	<N>
날짜 정확히 지키 어 주 시 어서 감사 드리 고 세탁기 적 게 보이 는데 이 불 넣 어도 끄덕 없 네요	<P>
전화 받 으니 엄청 짜증 섞이 ㄴ 목소리 의 남자 분 이 오늘 배송 하 아 드리 ㄴ다고 하 더라구요	<N>
공간 많이 차지 않하고 조용 하 게 세탁 잘 되 네 요	<P>
그런데 무턱대고 저희 집안 까지 세탁기 가지 고 들어오 시 어서 는 분명 집 앞 에서 전화 하 아 달 라고 하 았 습니다 따님 이 집안 으로 가지 고 오 라고 하 았 다고 박박 우기 시 는 것 이 ㅂ니다	<N>
감사	<P>
제 가 방 에 있 었 는데 아마 저 없 는 줄 알 고 저 한테 덮 어 씌우 는지	<N>
남동생 이 이사 가게 되 어서 선물 로 준비 하 았 는데 넘 맘 에 들 어 하 네 요	<P>
이 라는 타이틀 이 아깝 더군요	<N>
위 에 안 이 보이 게 되 어 있 어 참 좋 구요	<P>
세탁기 사용 하 아 보 니 좋 습니다	<N>
깔끔 하 ㄴ 색상 에 디 이 지 이 ㄴ 참 가격 대비 좋 은 상품 이 ㅂ니다	<P>
세탁기 설치 장소 가 바닥 높이 보다 높 은 편 이 ㄴ데다 그전 다른 제품 들 이 그 자리 에 딱 맞 게 설치 가능 하 었 는데 이 제품 은 앞뒤 길이 가 맞 지 않 아서 바닥 에 벽돌 놓 고 그 위 에 세탁기 를 놓 아서 아주 보 기 싫 어요	<N>
감사 하 ㅂ니다	<P>
세탁기 다리 가 기존 다른 제품본다 앞 으로 나오 아 있 어서 저희 집 처럼 바닦보다 높 은 면 에 휴	<N>
하하 아 좋 다 좋 다 좋 은 거 같 아요	<P>
공간 이 넓 은 집 들 은 상관없 겠 지만 일 기다리 어서 설치 하 ㄴ 제품 치고 는 에 휴	<N>
약 가 작 은데 좀 귀엽 ㅁ	<P>
한숨 만 나 오 네 요	<N>
아 하 아 하 아 하 아 하 아 좋 아요	<P>
세탁기 실물 을 보 니 깔끔 하 고 괜찮 았 습니다	<N>
좋 음	<P>
그런데 통 돌 이 의 비극 이 라 소리 가 좀 요란 스럽 기 ㄴ 하 데 요	<N>
괜춘한듯 괜춘	<P>
그래도 만족 이 ㅂ니다	<N>
내년 월 에 애기 가 태어나 는데 갑자기 세탁기 가 고장 나 서 마련 하 게 되 었 는데 마켓 에서 최저 가로 산 세탁기 가 애기 옷 빨 ㄹ 때 에 항균 작용 도 하 ㄴ다고 하 아서 와이프 가 너무나 좋 아 하 ㅂ니다	<P>
세탁기 아주 친절 하 게 잘 설치 하 아 주 시 어서 세탁 한 번 돌리 었 는데 만족 하 ㅂ니다	<N>
디자인 도 좋 구	<P>
그거 쉽 게 빼 는 방법 이 없 나	<N>
물론 일반 세탁기 보다 드럼 세탁 기 가 좋 다고 하 시 는 분 들 도 있 지만 시간 도 오래 걸리 고 거품 도 많 은 드럼 보다 는 일반 세탁기 가 가격 면 에서 부담 도 덜하 구 좋 더라구요	<P>
소리 가 요란 하 기 ㄴ 좀 그러 네 요	<N>
배송도 비교 적 빠르 아서 좋 았 습니다	<P>
일 반 세탁기 랑 비슷 한 것 같 기 도 하 고	<N>
내부 가 모두 스텐 이 라 깔끔 하 네 요	<P>
배송 하 시 는 분 이 친절 하 시 더라고 요	<N>
사용 하 아 보 지 ㄴ 않 았 지만 품질 도 좋 을 거 이 라 믿 어요	<P>
더 좋 은 거 ㄹ 사 아야 하 았 나	<N>
냉장고 사이즈 도 굿 이 고 디자인 도 굿	<P>
어쨌든 잘 빨리 는 것 같 구 배송 이나 설치 서비스 는 완전짱	<N>
만족 하 ㅂ니다	<P>
오 ㄴ다는 날 에 죙일 못 나가 고 기다리 었 는데	<N>
냉장고 세탁기 가스렌지 주문 하 았 는데 배송 은 제일 빠르 았 어요	<P>
쳇 다신 그런 실수 하 지 마시 기 ㄹ	<N>
대체 적 으로 만족 하 ㅂ니다	<P>
세탁기 정말 잘 받 았 습니다	<N>
잘 산 것 같 아서 뿌듯 하 ㅂ니다	<P>
그런데 소음 이 약간 심 하 ㅂ니다	<N>
한복석 기 사 님 과 같이 오 시 ㄴ 젊 은 기사 님 두 분 다 넘 친절 하 아서 감사 드리 ㅂ니다	<P>
세탁기 정말 좋 네요	<N>
배달 하 아 주 시 ㄴ 전자 직원 분 들 이 너무 친절 하 시 네요	<P>
잘 받 았 습니다	<N>
냉장고 도 깨끗 하 고 또 설치 하 시 ㄴ 기사 분 들 도 무지 친절 하 시 네요	<P>
단지 흰색 이 라 그리고 꽃 그림 에 도 펄 이 없 어 좀 초라 하 아 보이 어요	<N>
배송 오 자마자 빨래 하 아 보 았 는데 작동법 도 넘 간단 하 고 조 아 요	<P>
그거 말 고는 대 만족 이 ㅂ니다	<N>
냉장고 랑 세탁기 구입 하 았 는데 세닥 기 는 탈수 하 ㄹ 소리 가 좀 크 ㄴ 거 빼 곤 좋 네요	<P>
세탁기 가 고장 나 아서 새로 구입 하 ㄴ 것 이 ㄴ데 배송 이 너무 느리 어서 그 동안 빨래 도 못하 고 불편 이 많 았 습니다	<N>
번창 하 시 어요	<P>
게다가 일요일 날 배송 되 는 것 은 조금 아니 라고 생각 하 ㅂ니다	<N>
냉장고 살 때 는 느리 었 는데 세탁기 는 빨리 오 았 네요	<P>
그리고 설치 를 제대로 하 아 주 시 고 가 ㄴ 건지 의심 이 들 네 요	<N>
빨래 도 잘 되 고 섬유유연제가 자동 투입 되 는 것 이 좋 네요	<P>
세탁기 가 자꾸 움직이 어 서 요	<N>
생각 보다 는 작 았 지만 공간 덜 차지 하 아서 좋 은 듯	<P>
여튼 가격 대비 상품 은 괜찮 습니다	<N>
너무 괜찮 습니다	<P>
아 그리고 대우전자 에서 자꾸 괜찮 냐고 확인 전화 오 는데 좀 짜증 이 나 ㅂ니다	<N>
크기 도 적당 하 고 잘쓰렵니다	<P>
세탁기 가 고장 나 아서 지나 ㄴ 토욜 급하 게 주문 하 았 는데 일주일 이 다 되 가 도 아직 도 배 송전 에다가 배송 지연 문구 뜨 네 요	<N>
중고 사 려다가 지 마켓 에서 쌓 ㄴ 거 구입 하 았 는데 명 이서 쓰기겐 딱 이 ㅂ니다	<P>
빨래 는 쌓이 어 가 고 이럴려면 오프라인 에서 구매 하 아 배송받는거였느데	<N>
너무 귀엽 고 식구 가 쓰기 에 도 좋 은 듯	<P>
몇 만 원 아끼 려다 기분 만 나쁘 아 지 네 요	<N>
너무 기분 좋 아요	<P>
세탁기 가 고장 은 아니 지만 오래 되 어서 삼성 하고 비교 하 면서 고심 하 아서 구입 하 었 는데 소음 은 좀 실망 일 이 ㅂ니다	<N>
아직 빨래 하 ㄹ 것 이 없 어 못하 았 지만 쌓 ㄴ 가격 에 너무 잘 살 ㄴ 것 같 아요	<P>
그거 말 고 다른 건 모두 만족 일 이 ㅂ니다	<N>
무엇 보다 헹굼횟수가 번 되 ㄴ다는 것 이 절 기쁘 게 하 ㄴ답니다	<P>
기사 분 도 친절 하 시 고 넘 아담 하 아서 귀여긴 하 내 요	<N>
너무 너무 마음 에 들 어요	<P>
단점 이 라면 수도꼭지 끼우 는 곳 이 헐겁 게 나오 아 물 이 셀랑말랑 고이 어 있 어요	<N>
너무 너무 저렴 하 게 얼마나 좋 았 는지 모르 아요	<P>
이 를 어찌 하 아야 하 ㄴ지 난감 하 네 요	<N>
주정 도 기다리 기 ㄴ 하 았 지만 방문 기술자 님 도 아주 친 철 하 아서 마음 에 들 었 답니다	<P>
설치 기사 분 들 은 좋 았 어요	<N>
너무 너무 조 아 요	<P>
세탁기 는 괜찮 아요	<N>
대우 라 서 약간 망설이 었 는데요 흠 하 나 없이 깔끔 하 고 세탁 도 잘 되 는 거 같 아요	<P>
그런데 배송 이 너무 느리 군요	<N>
너무 너무 좋 아요	<P>
그것 만 고치 어 주 시 어요	<N>
너무 너무 좋 아요	<P>
세탁기 는 괜찮 은 듯	<N>
완전 강력 추천 제품 입 다	<P>
무 저렴 하 ㄴ 가격 에 좋 은 물건 을 구입 하 아서 만족 하 ㅂ니다	<N>
아직 개시 는 못 보 았 지만 너무 좋 습니다	<P>
근데 행굼세제 자동 투입 이 라서 그러 ㄴ지 삐삐 하 는 수동식 세탁기 소리 가 안 나 는 것 이 불편 요	<N>
색상 도 너무 이쁘 고 디자인 도 너무 만족 스럽 어요	<P>
세제 넣 는 곳 이 있 기 ㄴ 한데 통 이 나누 어 지 지 않 아서 행 굴 때 는 알 아서 보 시 고 넣 으시 시 어야 하 아요	<N>
빠르 ㄴ 배송 과 제품 설치 도 친절 하 게 전화 로 연락 하 아서 설치 하 아 주 시 고 잘 하 아 주 시 네요	<P>
하 ㄹ 뻔 하 았 는데 세탁기 를 돌리 어 보 니 세탁 만 되 고 헹구 ㅁ 이 안되 었 었 다는	<N>
역시 삼성 제품 이 만족 스럽 네 요	<P>
첨 에 ㄴ 무엇 도 모르 고 제품 이 잘못 되 었 나 보 다 싶 어 서비스 센터 전화했죠	<N>
가격 대비 매우 매 우 만족스럽습니다	<P>
교환 이나 받 아야 하 겠 다 햇는데 대우 서비스 꽝	<N>
세탁기 를 사용 하 아 보 니 빨래 엉킴도 없이 깨끗이 빨 아 지 는 것 이 너무 너무 만족 스럽 고 세탁기 디자인 도 화면 보다 실제로 보 니 더 세련 되 고 이쁘 고 맘 에 들 어요	<P>
이래저래 하 다 하 았 더니 받 아야 된다믄서 받을라믄 일주일 이상 걸리 ㄴ대 요	<N>
세탁기 도 맘 에 들 고 설치 하 아 주 시 ㄴ 삼성 기 사 분 의 서비스 에 더 감동 감동	<P>
내 참 그래도 별수 있 나	<N>
너무 맘 에 들 어요	<P>
그래서 예약 하구 몇일 가 ㄴ 세탁기 못썼습니다	<N>
잘 빨려요	<P>
헐 이렇 게 간단 하 ㄴ 것 이 ㄴ데 암만 설명 하 아 주 어 보 아야 무조건 받 아야 되 ㄴ다 그러 고 당췌 그 설치 기사 는 무엇 이 냐고	<N>
너무 맘 에 들 ㅂ니다	<P>
세탁기 는 좋 고 설치 도 물류 회사 에서 직접 오 아서 깔끔 하 게 설치 하 아 주 어서 만족 하 아요	<N>
이 가격 에 이 정도 면 은 사도 후회 안 하 시 ㄹ 듯	<P>
그러나 배송 이 너무 느리 어 요	<N>
빠르 ㄴ 배송 과 친절 하 ㄴ 서비스 적 근 추천 이 ㅂ니다	<P>
배송만 빠르 았 으면 좋 겠 어요	<N>
대우 이 라 꺼리 었 는데 기대 이상 넘 좋 아요	<P>
배송 에 만 좀 더 신경써주시면 좋 겠 구요	<N>
너무 이뻐요	<P>
제품 은 가격 대비 아주 만족 하 ㅂ니다	<N>
제품 도 너무 좋 구요	<P>
다만 흰 세탁 물 과 색 있 는 세탁물 을 같이 빨 면 흰 세탁 물 이 조금 때 가 덜 빠지 더라구 요	<N>
설치 해 주 신분 도 너무 친절 하 시 고 암튼 좋 습니다	<P>
크기 는 확실히 키로 이 라 하 기 에 ㄴ 좀 많이 작 네요	<N>
너무 이쁘 고 실속 도 넘 좋 아요	<P>
우리 식구 쓰기 에 ㄴ 생각 보다 많이 작 아서 조금 걱정 이 ㅂ니다	<N>
너무 잘 사용 하 고 있 습니다	<P>
세탁기 는 하루 늦 게 도착 하 았 어요	<N>
설치 기사 아저씨 가 넘 친절 하 시 어서 쑥스럽 ㄹ 정도 이 었 지만 처음 부터 끝 까지 다 친절 하 게 하 아 주 시 어서 좋 았 습니다	<P>
대우 제품 이 일단 디자인 자체 가 군더더기 가 없 어서 크 ㄴ 용량 이래 도 공간 을 많이 차지 하 지 않 아서 좋 네요	<N>
너무 잘 살 ㄴ 것 같 아요	<P>
그런데 배송 날짜 맞추 느라 기사 분 이 바뀌 시 었 는지 자기 가 배송 하 는 것 이 냉장고 이 지 세탁기 이 지 도 모르 고 전화 하 아서 사람 을 헷갈리 게 하 질 않 나	<N>
너무 잘 쓰 고 있 어요	<P>
공휴일 아침 시 에 전화 를 죄송 하 다는 말 도 없이 세 번 이나 연거푸 해 대 질 않 나	<N>
너무 잘 쓰 고 있 어요	<P>
이름 도 제대로 못 듣 고 어리버리 사람 을 돌 게 만들 는 재주 가 있 으시 ㄴ 그 분	<N>
깨끗 하 고 세탁 또 한 산뜻 하 ㅂ니다	<P>
지금 다시 생각 하 아도 열 받 네 요 진짜	<N>
배달 하 신분 이 너무 친절 하 게 하 아 주 시 어서 감사 하구 요	<P>
방문 기사 분 이 잘 하 아 주 시 었 기에 망정 이 지 대우 본사 에 이 라도 전화걸 참 이 었 습니다	<N>
너무 조앙	<P>
끝 까지 사과 한 마디 안 하 시 고 친절 은 커녕 기본 도 안 되 있 는 것 같 았 네요	<N>
너무 좋 구요	<P>
그 분 이 많 은 기사 분 들 중 에 한 분 이 시 겠 지만 방문 기사 님 처럼 친절 하 고 일 똑바로 처리 하 고 프로 정신 넘치 는 사람 이 수백 이 어도 이런 사람 때문 에 기분 나쁘 고 열 받 고 짜증 나 는 일 이 없 었 으면 좋 겠 네요	<N>
가격 도 넘 맘 에 들 어요	<P>
세탁기 도 좋 지만 배송 이 더 마음 에 들 어요	<N>
세탁기 돌리 어 보 았 는 데 요 소리 도 작 아서 좋 더라구요	<P>
가격 대비 완젼 대 만족 이 요	<N>
너무 좋 네요	<P>
상품 은 좋 은 것 같 습니다	<N>
물건 이야 본사 에서 직접 오 는 거 이 니까 말 하 ㄹ 것 도 없 겠 거니와 배달 하 아 주 시 는 기사 분 도 직접 본사 에서 나오 시 어서 그러 ㄴ지 너무 친절 하 시 고 설명 도 잘 하 아 주 시 네요	<P>
세탁기 를 배달 하 아 오 았 는데 아저씨 가 세탁 실 로 넣 어야 하 는데 대충 하 아 보 고 안 들 어 가 ㄴ다고 냉장고 에 놓 는 위치 에 설치 를 하 아 놓 고 가 아 버리 었 습니다	<N>
인터넷 이 라 솔직히 번 고민 할거 번 고민 하 게 되 고 물건 받 아 보 고 상태 확인 하고 나서 어도 고민 되 는데 이번 에 는 아주 만족스럽습니다	<P>
그래서 전화 를 하 아서 왜 세탁 실 에 설치 를 하 아 놓 지 않 고 거실 에다가 하 었 냐고 하 았 더니 들어가 지 않 아서 그렇 다고 하 었 습니다	<N>
설치 전 부터 전화 주 시 어서 배송 날짜 와 시간 알리 어 주 시 고 설치 후 에 도 직접 이것저것 사용법 을 가르치 어 주 시 더군 요	<P>
그럼 왜 저 에게 전화 를 하 었 는지 모르 겠 어요	<N>
너무 좋 아서 시골 에 계시 ㄴ 어머니 께 선물 하 고 저 두 사 았 어요	<P>
잘못 이 있 다고 하 니까 끊 어 버리 는 것 ㄴ 또 뭐 이 ㄴ지 알 ㄹ 수 가 없 습니다	<N>
같 은 것 루 참 좋 으시 네요	<P>
이런 서비스 정신 으로 물건 을 팔아먹 으니 대우 전자 를 욕먹 게 하 지 않 겠 습니까	<N>
너무 좋 아요	<P>
고객 감동 은 고사하고 손님 을 부리 어 먹 고 전화 하 아서 나쁘 다고 하 니까 끊 어 버리 고 이런 직원 들 을 방치 하 아 놓 으면 대우 는 영원히 등 밖에 하 ㄹ 수 가 없 거나 더 이상 가 ㄹ 수 도 있 다고 생각 하 ㅂ니다	<N>
감사 하 ㅂ니다	<P>
강력 하 게 추천 하 ㅂ니다	<N>
추천 하 ㅂ니다	<P>
어쨌든 잘 사용 하 고 있 습니다	<N>
너무 좋 아요	<P>
세탁 때 는 모르 겠 는데 탈 수시 모타 가 부딪치 어 찢어지 는 소리 찌찌찍소리 너무 시끄럽 어요	<N>
빨래 도 잘 되 고 모양 도 예쁘 네요	<P>
고장 이 ㄴ 줄 알 고 신청 을 하 었 는데 원래 나 는 소리 이 라는데 어쩌 ㄹ 수 없 다는데 정말 짜증 나 아요	<N>
너무 좋 아요	<P>
계속 사용 하 ㄹ 제품 이 ㄴ데 짜증 이 너무 나 네 요	<N>
설치 도 신경 쓰 어서 하 아 주 시 고 배송이 주정 도 걸리 었 지만 기사 님 들 도 친절 하 시 고 좋 은 물건 많이 파 시 어요	<P>
세탁력 좋 고 감사 하 ㅂ니다	<N>
너무 좋 아요	<P>
세탁 시간 도 길 구 탈수 를 하 아도 물기 가 말 니 남 아 이 었 네요	<N>
맘 에 들 어서 좋 습니다	<P>
세탁 하 ㄹ 때 너무 소리 가 요란 하 네 요	<N>
너무 좋 은 것 같 아요	<P>
그래도 저렴 하 ㄴ 가격 에 빨래 는 잘 되 ㅂ니다	<N>
쿠폰 으로 저렴 하 게 구입 하 아서 더욱더 좋 아요	<P>
소리 가 장난 아니 네요	<N>
추천 하 ㅂ니다	<P>
잘 빨리 면 그만 이기 ㄴ 하지만 짜증 내 는 이웃 이 옆 에 있 다면 비 추 이 ㅂ니다	<N>
너무 친절 하 고 좋 네요	<P>
소음 이 상상 밖 으로 큼니다	<N>
너무 친절 하 시 어서 굿	<P>
빨래 도 더 잘 되 는 것 같 고 좋 네요	<N>
설명 도 자세히 하 아 주 시 고 설치 하 시 고 박스 랑 쓰레기 도 가져가 아 주 시 는 센스	<P>
소리 가 좀 크 ㄴ 거 같 기 ㄴ 하 ㄴ데	<N>
너무 친절 하 시 고 빠르 ㄴ 배송 감사 하 ㅂ니다	<P>
다른 건 다 좋 네요	<N>
물론 물건 도 맘 에 들 고요	<P>
소문 대로 소음 이 좀 심하 네 요	<N>
너무 편 하 고 세탁 도 잘 되 고 좋 아요	<P>
그거 빼 고 다른 건 좋 습니다	<N>
너무나 빠르 ㄴ 배송 에 놀라 았 습니다	<P>
소음 도 그리 심하 지 않 고 좋 습니다	<N>
디자인 도 이쁘 구요	<P>
다만 한가지 걸리 는 것 은 배송 이 좀 느리 ㄴ 편 이 ㄴ데다 질문 에 대하 ㄴ 답변 이 없 다는 거	<N>
콤펙트형이라 공간 도 안 차지 하 구 기사 님 이 친절 하 게 설치 하 아 주 시 어서 감사 드리 ㅂ니다	<P>
그것 만 아니 면 제품 에 대하 아서 ㄴ 뭐 나무라 ㄹ 것 이 없 었 어요	<N>
이 제품 강추합니다	<P>
데 도 싸이즈 가 예전 에 비하 아 작 네요	<N>
너무나 친절 하 게 설명 하 아 주 시 고 안전 하 게 설치 하 아 주 어서 대 만족	<P>
소음 은 조금 크 ㄴ 거 같 으시 네요	<N>
홈쇼핑 에서 가전 은 처음 구입 하 았 는데 쓰 어 보 니까 너무 괜찮 음	<P>
다른 것 보다 좀 크 게 들리 어요	<N>
너무나 친절 하 ㄴ 설치 기사 분 들 에게 정말 감사 드리 ㅂ니다	<P>
그런데 탈수 하나 는 짱 이 ㅂ니다	<N>
품질 은 아주 죽 이 ㅂ니다	<P>
전차 소리 랑 맞먹 는데 이것 이 정상인 가요	<N>
판매자 님 대 박 나 시 어요	<P>
소음 이 조금 있 기 는 하 지만	<N>
배송 두 빠르 았 구 설치 하 아 주 시 는 아저씨 두 친절 하 시 었 구 전 맘 에 들 네 요	<P>
소음 이 조금 있 기 는 한데	<N>
크기 두 적당 하구 여	<P>
가격 대비 맘 에 들 ㅂ니다	<N>
그동안 세탁기 없이 불편 하 았었 는데 넘 좋으네용	<P>
하지만 이 가격 에 괜찮 은 세탁기	<N>
너무너무 기대 되 ㅂ니다	<P>
소음 이 좀 생각 보다 심하 ㄴ 듯	<N>
너무너무 마음 에 들 ㅂ니다	<P>
소음 이 좀 심하 ㄴ 듯 한 면 도 있 지만 저렴 하 게 잘 구매 하 ㄴ 것 같 습니다	<N>
배송도 좋 고 제품 도 좋 고 가격 은 환상 이 고 너무너무 마음 에 들 ㅂ니다	<P>
소음 이나 진동 은 약하 지 않 고 조금 은 크 ㄴ 편 이 네요	<N>
번창 하 시 고 대 박 나 시 어요	<P>
아주 쬐금이여	<N>
아 글쎄 마음 에 들 ㄴ다니까 요	<P>
근데 집 에 있 는 삼성꺼도 데 것 보 다는 많이 작 아요	<N>
너무너무	<P>
위쪽 에 있 어서 빨래 를 많이 하 ㄹ 때 는 괜찮 겠 지만 소량 으로 빨래 를 하 ㄹ 때 는 먼지 가 걸리 어 지 지 않 을 것 같 네요	<N>
배송도 좋 구요	<P>
아무래도 신청 을 하 아서 받 아 보 아야 하 ㄹ 것 같 습니다	<N>
깨끗 하 게 잘 포장 되 어 오 았 습니다	<P>
수평 맞추 는 기포 동그라미 도 없 고 물 넣 고 대충 맞추 어야 하 ㄴ다는	<N>
호호호	<P>
이불 빨래 해보 니 완전 드럼 치 네 요	<N>
너무너무 좋 아요	<P>
수평 이 안 맞 아 그러 ㄴ가 보다 하 고 다시 기사 부르 어 보 아 달 라고 하 었 더니 이상 없 다고	<N>
배송도 물건 도 너무 맘 에 들 ㅂ니다	<P>
흠 요즘 나오 는 것 은 원래 그렇 다는데 예전 에 쓰 던 것 은 안 그러 는데 년 수 도 년 이 되 었 지만 조용 하 었 는데	<N>
진짜 강츄	<P>
에 공 이제 어쩌 ㄹ 수 없이 드럼 세탁기 로 가 아야 하 는 것 이 ㄴ가	<N>
너무너무 좋 아요	<P>
그전 에 쓰 던 삼성 세탁기 보 단 탈 수력 이 떨어지 기 ㄴ 하 아요	<N>
배송도 빠르 네요	<P>
시간 약속 을 아침 일찍 하 았었 는데 비 가 오 는 바람 에 약간 늦 어 지 게 되 었 다면서 아침 일 찍 전화주 신 배송 기사 님 감사 하 ㅂ니다	<N>
세탁기 아저씨 너무너무 친절 하 시 어요	<P>
약간 상품 의 색상 자체 가 좀 부족 하 ㄴ 듯 하 ㅂ니다	<N>
세탁기 가 아주 욕실 에 안성맞춤 딱딱 맞 아요	<P>
자식 이 사주 는 물건 이 라고 흡족 하 시 며 설명 도 잘 하 아 주 더라고 말씀 은 하 시 었 지만 시일 도 일주일 이나 걸 ㄹ 리 고 좀 기분 이 썩 좋 지 는 않 았 어요	<N>
너무너무좋아요잉	<P>
낮 에 는 집 에 사람 없 다고 분명히 얘기 하 았 는데도 저녁 에 는 배달 안해 주 ㄴ다고 하 아서 회사 다니 는 오빠 가 세탁기 받 으러 낮 시간 에 집 으로 갔다네요	<N>
너무 조 아 요	<P>
진짜 세탁기 호수 가 짧 아서 그러 다는데 세탁기 반대쪽 으로 돌리 어 놓 으면 충분히 설치 하 ㄹ 수 있 는데 전 에 도 그렇 게 사용 하 았었 는데 밤 에 세탁기 호 수사 와 서 오빠 가 대신 설치 하 었 답니다	<N>
배송 두 신속 하 시 구 넘 친절 하 시 구	<P>
아주 늦 지 않 은 저녁 시간 이 면 오 시 어서 설치 도 하 아 주 시 고 노인 이 사용 하 ㄹ 거 이 니까 사용 설명 도 좀 하 아 주 시 고 그렇 어야 하 는 거 아닌가요	<N>
어머니 께서 너무 좋 아 하 시 네요	<P>
설치 기사 님 정말 맘 에 들 지 않 습니다	<N>
너무 좋 음	<P>
선물 하 ㄴ 제가 엄마 한테 미안 하 았 으니까요	<N>
사용 잘 하 고 잇습니니다	<P>
시골 에 계시 ㄴ 할머니 댁 에 새로 놓 아 드리 었 는데 너무 좋아하 시 네요	<N>
인터넷 으로 물건 사본 적 이 별로 없 어서 괜찮 을까 고민 하 다가 사 고 싶 었 던 물건 을 하루 반 나 절 이 지나 아서 겨우 찾 았 던 거 이 라 받 자마자 너무 좋 아 얼른 사용햇어요	<P>
어쩌 어 이 든 잘 아 쓰 고 있 다고 하 시 니 다행 이 ㅂ니다	<N>
넘 괜찮 은 것 같 으시 네요	<P>
판매자 쪽 에서 담당 하 아서 제대로 지키 어 주 어야 하 는 거 아닌가요	<N>
가격 대비 상품 이 너무 괜찮 은 것 같 아요	<P>
살짝 그 부분 에서 서비스 좀 낮 게 주 ㅂ니다	<N>
디자인 도 마음 에 들 고 기능 도 간단 하 고 특히 배달 하 아 주 시 는 분 이 너무 친 질 하 고 잘 설명 하 아 주 시 고 너무 좋 았 습니다	<P>
판매자 쪽 에 전화 하 아서 이것저것 물어보 았 을 때 는 답변 을 잘 하 아 주 어서 아 괜찮 겠 구나 하 고 구매 를 하 었 는데 아무쪼록 배송 이나 기타 부분 에 신경 을 좀 쓰 시 어야 하 겠 습니다	<N>
좋 은 제품 감사 하 고요	<P>
받 는 측 에서 는 이런 부분 에서 예민 하 거든요	<N>
대 박 나 시 어요	<P>
아무래도 나중 에 재 구매 에 대하 아서 는 다시 생각 하 게 되 ㄹ 것 이 ㅂ니다	<N>
완전 감동 이 라면서 전화 가 몇 통 오 았 는지 모르 아요	<P>
낮 에 만 사용 하 아야 하 ㄹ 듯	<N>
넘 빠르 ㄴ 배송 에 친절 하 ㄴ 설치 가격 에 비하 아 넘 좋 은 상품강추	<P>
보름넘게 손 빨래 를 하 시 었 다고 해서 요	<N>
넘 싸 아서 망설이 었 는데 정말 잘 구매 하 았 다는 생각 이 들 ㅂ니다	<P>
시어머님 생신 선물 로 사 드리 었 는데 빠르 ㄴ 배송 에 너무 감사드리구여	<N>
가격 은 저렴 하 지만 새 제품 에 성능 또한 만족 하구 요	<P>
암튼 제품 은 만족 스럽 고 잘 사용 하 겠 습니다	<N>
적극 추천 하 아도 손상 이 없을둣	<P>
왜 말씀 안 하 아 주 시 었 습니까	<N>
넘 잘 산 것 같 아요	<P>
덕분 에 드럼 세탁 기 로 다시 구매 하 았 습니다	<N>
작동 도 편하 고 그리고 배송 도 정확히 맞추 어 주 시 고 너무너무 친절 하 시 었 어요	<P>
근데 넘 시끄럽 어요	<N>
넘 만족 한 답 니 다	<P>
제 가 쓰 던 일 반 세탁기 보다 더 시끄럽 아 밤 에 세탁기 쓰기 가 좀 꺼리 어 지 지만 이만한 가격 에 좋 은 세탁기 가 생기 어 기분 이 좋답니다	<N>
넘 잘 네요	<P>
세탁 시 소음 이 저번 세탁 기 보다 좀 더 심 하 ㅂ니다	<N>
빨래 도 잘 되 고 가격 대비 넘 맘 에 들 어요	<P>
기사 님 들 오 시 어서 바닥 청소 에 친절 하 ㄴ 비스 하나 는 확실 하 게 좋 습니다	<N>
친절 하 구 시간 약속 두 잘 지 키 시 구 대 만족 이 ㅂ니다	<P>
심 하 ㅂ니다	<N>
넘 좋 습니다	<P>
전 뭐 그냥 쓰 ㄹ 생각 이 지만 소음 에 민 감 하 신분 들 은 참고 하 시 어요	<N>
배달 해 주 신분 도 넘 친 절하 고 여 세탁기 도 겹 네요	<P>
싸 게 구입 하 아서 좋 네요	<N>
배송도빠르구기사 아저시도좋아용	<P>
근데 배송 은 좀 늦 네요	<N>
소음 도적 구 탈 수도 잘 되 어요	<P>
싸 고 좋 네요	<N>
넘맘에들어여	<P>
그치 만 배송이 넘 느렸더	<N>
좋 은 물건 넘싸게 주 시 어서 감사 하 ㅂ니다	<P>
싸 구 작 구 좋 아요	<N>
번창 하 시 구 수고 하 세 여	<P>
싸이즈 가 작 아서 안성맞춤	<N>
가격 대비 품질 좋 구요	<P>
싸이트 내용 금액 과 실제 결제 할 때 금액 하 고 차이 가 나 네 요	<N>
배송도 약속 한 시간 지키 어 주 시 고 설치 기사 분 들 이 너무 친절 하 시 어서 아주 만족 이 ㅂ니다	<P>
빠른시정부탁드림니다	<N>
직배 송이 이 고 디자인 도 이쁘 고	<P>
왠지 낚이 ㄴ 거 같 은 느낌 이 들 어서요	<N>
배송 하 시 는 분 도 아주 친절 하 시 구요	<P>
다음 구매하리실 분 들 은 금액 을 꼭 확인 을 하시 고 구매 하 시 어요	<N>
빨래 도 잘 되 ㅂ니다	<P>
싸 지만 알 차 네 요	<N>
바람탈수는 아직 안써봤지만 빨리 건조 하 아야 하 ㄹ 때 사용 하 면 좋 을 것 같 네요	<P>
암튼 설치 랑 잘 하 아 주 시 어서 감사 하 ㅂ니다	<N>
기사 님 들 도 친절 하 고 좋 았 습니다	<P>
쌓 ㄴ 것 이 비지떡 이 라더니 그말이딱맞군요	<N>
시험 가동 하 구 매우 만족햇습니다	<P>
이용 후기 처럼 저희 집 세탁 기 키로 보다 ㄴ 작 은 듯 하 아서 애들키우는 집 에 ㄴ 별루 이 ㄹ 듯 하 ㅂ니다	<N>
수고 하 시 고 번창 하 시 어요	<P>
하지만 저희 도련님 처럼 혼자 자취 하 기 에 ㄴ 별 불편 하 ㅁ 은 없 을 듯 하 아서 구입 하 았 는데 서비스 가 이렇 어서 되 겠 습니까	<N>
다 만족 하 ㅂ니다	<P>
다른 제품 다른 회사 많이 용 하 아 보 았 지만 이렇 게 설치 후 박스 를 현관 앞 에 두 고 간 적 은 없 었 습니다	<N>
배달 기사 아져씨 꼼꼼히 보 아 주 시 고 절 말 맘 에 들 ㅂ니다	<P>
스치로품 부스러기 에 크 ㄴ 박스 가 문 여 는 데 바로 앞 에 있 어서 나오 다가 깜짝 놀래 었 습니다	<N>
옷 은 빨 아 보 아야 알 겠 지만 지금 으로써 는 만족 하 ㅂ니다	<P>
장난 이 아니 더군요	<N>
다 좋 아요	<P>
베란다행거기둥도 밀 어 놓 은 채 그대로 가시 더니 좀 황당 하 ㅂ니다	<N>
다 들 기사 분 칭찬 을 하 시 던데 저 역 시도 그러 네 요	<P>
요즘 이 어떤 시대 이 ㄴ데 그렇 게 하 시 ㅂ니까	<N>
오 시 기 전 에 몇 번 이 나 전화 주 시 고 감사하드라구요	<P>
물건 을 팔 때 ㄴ 서비스 도 함께 파시 길 정중히 부탁 하 ㅂ니다	<N>
상품 도 괜찮 았 습니다	<P>
쓰 어 보 니까 역시 삼성 이 에요	<N>
설치 하 아 주 시 는 아저씨 가 구 모델 수거 하 아 주 시 고 친절 하 아서	<P>
그런데새거냄새가너무많이나요	<N>
지금 밀리 ㄴ 빨래 를 하 고 있 는데 잘 되 는 것 같 아요	<P>
그래도 만족 하 ㅂ니다	<N>
많이 팔 시 고 대 박 나 시 어요	<P>
인터파크 가 배송늦은적이 없 었 는데 일 하 는 거 보 면 실망 스럽 네 요	<N>
세탁물 도 보들보들하니 좋 아 네 여	<P>
배송 이 늦 어 지 ㄴ다고 전화 한 통 주 ㄴ 것 도 아니 고	<N>
만족 하 ㅂ니다	<P>
어르신 들 은 기다리 시 는데 인터파크 에서 이런 판매자 는 페널티 주 어야 하 ㅂ니다 정말	<N>
다른 보다 조금 작 은 듯 하 아서 이불 빨래 가 되 ㄹ런지 모르 겠 지만 디자인 이나 일반 빨래 모두 맘 에 들 어요	<P>
아가땜에 정신 이 하나 두 읍어서리 평 이 늦었네염	<N>
무엇 보다 가격 이 저렴 하 니까 좋 아요	<P>
요즘 인터넷 쇼핑 문제점 들 문 에 좀 불안 하 기 ㄴ 하 았 는데 인터파크 이 라 좀 더 믿음 이 가 았 네요	<N>
드럼 세탁기 사 려다 일반 세 타기 사 았 는데 괜찮 은 것 같 습니다	<P>
아니 이렇 게 좋 은 물건 을 이 가격 에 진짜 감사 하 ㅂ니다	<N>
특히 어른 들 이 쓰실일 있 으시 면 일반 세탁기 가 사용 하 기 편하 시 ㄴ 것 같 더라구요	<P>
기다리 고 있따가 다 돌아가 아 버리 어서 달 시 물 받 아 헹궜어여	<N>
빠르 ㄴ 배송 친절 하 ㄴ 기사 님 에서 빨리 설치 하 아 주 시 었 네요	<P>
이점 만 괜찮 다면 사용 하 시 어도 괜찮을꺼같아용	<N>
이것저것 자세히 사용 방법 도 가르치 어 주 시 고 감사 하 ㅂ니다	<P>
이번 에 는 다행 이 도 오늘 배송 하 아 주 시 어서 너무 감사 하 ㄴ 마음 이 ㅂ니다	<N>
사이즈 도 작 은 곳 에 쏘옥만족합니다	<P>
아무런 연락 도 없이 배송 시간 만 길 어 지 어서 정말 짜증 이 나 았 다	<N>
세탁기 바로 이용 하 아 보 았 는데 옷감 이 구김 도 말 니 안 가 고 깨끗 하 게 잘 빨 아 지 네 요	<P>
아무튼 세탁기 하나 는 잘 산 것 같 습니다	<N>
번창 하 시 어요	<P>
자동 이 라 세탁 세기 수 중 강 타 아서 이 ㄴ가요 오 아 헹구 ㅁ 횟수 를 조절 하 ㄹ 수 없 습니다	<N>
특히 소음 없이 조용 하 ㄴ 것 이 가장 맘 에 들 ㅂ니다	<P>
아자씨 친절 하 고 지정배송했는뎅 딱 마차 주 시 었 어 염	<N>
다른 브랜드 상품 과 여러 가지 로 비교 하 다 비교 적 가격 경쟁력 에서 앞서 는 이 세탁기 로 결정 을 하 었 는데 사용 을 일주일 해보 ㄴ 결과 아주 맘 에 들 ㅂ니다	<P>
밤 에 는 사용 하 기 조금 어렵 ㄹ 듯 하 ㅂ니다	<N>
트롬에 비하 아서 소음 도 그닥 크 지 도 않 고 세탁 도 아주 잘 되 구요	<P>
아주 만족 하 ㅂ니다	<N>
이불 도 누비이불 과 침 대 카바 도 들어가 ㄹ 정도 의 키로 용량 이 니 널널하여 좋 습니다	<P>
아주 잘빨려요	<N>
가격 대비 아주 강추에요	<P>
근데 그전 상품 평 처럼 조금 소리 가 크 네요	<N>
제품 도 실제로 보 면 더 이쁘답니다	<P>
아주 저렴 하 게 사 았 는 디 배송 까지 도 빠르 고 또 아주 친절 하 아서 좋 았 어요	<N>
배송 직원 분 들 도 친절 하 게 설치 애 주 시 고 배송도 총알 이 었 구요	<P>
설치 기사 님 은 굉장히 친절 하 시 ㅂ니다	<N>
역시 세탁기 는 대우 이 ㅂ니다	<P>
물건 을 시키 ㄹ 때 마 다 배 송이 느리 네 여	<N>
다른 사람 들 이 드럼 세탁 기 는 소리 가 크 다 하 었 는데 생각 보다 크 지 도 않 고 공간 도 많이 차지 하 지 않 고 좋 아요	<P>
부탁드릴께여	<N>
사용법 도 편하 구요	<P>
주 아이 벨 리 에 배송 날짜 건 으로 문의 하 았 을 때 되 ㄹ 수 도 있 고 안 되 ㄹ 수 도 있 다는 퉁명 스럽 고 짜증 스럽 ㄴ 상담 에 기분 이 매우 상하 았 었 습니다	<N>
기사 님 도 친절 하 시 구요	<P>
지정 배 송 날 일전 에 전화 상담 을 하 면서 그 날짜 에 배송 이 안 되 면 미리 고지 를 하 아 주 었 어야 하 는 거 아니 냐는 말 에 한숨 을 쉬 며 자기 도 미리 알 ㄹ 수 없 는데 어떻 게 얘기 를 해 주 나 며 짜증 을 내 더군요	<N>
다른 사람 이 사용 하 는데 좋 다고 하 네 요	<P>
배달 및 설치 하 아 주 시 ㄴ 분 들 은 친절 하 시 어서 매우 고맙 었 습니다	<N>
다른 상품 대비 가격 저 렴 평범 하 고 무난 하 ㄴ 좋 은 세탁기 이 ㅂ니다	<P>
아직 사용 은 안 하 아 보 았 는데 좋 겠 죠 뭐	<N>
투 명창 도 좋 아요	<P>
안바쁘신 분 들 미리 준비 되 ㄴ 분 들 사세 요	<N>
배송 기사 님 도 친절 하 았 고 요	<P>
배송 은 많이 느리 었 구요	<N>
다른 상품 과 비교 하 면서 고민 하 었 는 데 서비스 가 좋 은 삼성 제품 이 라 더 마음 에 끌리 구요	<P>
에서 늦 게 만들 었 다구 하 네 요	<N>
상품 평 대로 일반 짜리 치고 는 아담싸이즈여서 귀엽 고요	<P>
그러나 넘 이뻐요	<N>
쓸데없 는 공간 낭비 도 없 어서 좋 습니다	<P>
약속 날 오지 도 않 고 이사 날 에 맞추 어 주 ㄴ다고 약속 하구 선	<N>
그리고 키로 가 아니 어서 좀 작 지 않 을까 하 었 는데 생각 보다 빨래 양도 넉넉 하 게 들어가 고 좋 아요	<P>
다른 분 들 은 친절 하 게 상세 설명 을 들 으시 었 다는데 저희 와이프 는 기분 나쁘 아 하 더라구요	<N>
오늘 받 고 설치 하 자마자 어제 오늘 밀리 었 던 빨래 를 돌리 었 는데 빨래 도 깨끗 하 게 잘 되 고 기분 이 넘 상쾌 하 ㅂ니다	<P>
배송 품질 가격 모두 맘 에 들 지만 기사 분 의 무 성의 하고 안일 하 ㄴ 태도 가 듣 는 저 도 기분 상하 더라구요	<N>
다른 회사 제품 과 성능 은 더 좋 은데 가격 은 더 싸 네 요	<P>
약속 하 시 ㄴ 시각 에 정확히 맞추 어 배송 하 아 주 시 었 네요	<N>
하얀색 으로 너무 깨끗 하 고 좋 아요	<P>
친정 부모 님 께 사 아 드리 는 것 ㄴ 데 내 시 ㅁ 기대 하 고 계시 었 는데 두 분 내심 화가 나 시 ㄴ 듯 하 었 다	<N>
감사 하 ㅂ니다	<P>
노인 네 들 약 속 하 ㄴ 날짜 에 오 지 못하 ㄴ다 하 니 젊 은 사람 들 이 융통 성 이 없 다는 둥 길 거리 에 삼성 세탁기 가 그렇 게 많 은데 왜 꼭 하 ㄴ 군데 에서 만 가져오 아야 하는거냐며역정만 한가득	<N>
후회 안 하 시 ㄹ 물품 이 듯	<P>
뭐 한 귀 로 듣 고 흘리 어 버리 었 다 그동안 살아오 시 ㄴ 게 있 어서 내 어 가 아 지금 설명 하 ㄴ들 잘 이해 못 하 시 ㄹ 것 뻔하 므로	<N>
다른 곳 에 선물할려샀는데많이저렴해서 좋 네요	<P>
그치 만 물 건 이 부족 하 ㄹ 것 을 예상 하 지 못 하 고 주문 을 받 은 업체 측도 문제 는 있 다	<N>
번창 하 시 어요	<P>
그리고 원래 배송 되 기 로 하 ㄴ 날 아침뜬금없이 전화 가 오 았 다	<N>
다른 분 들 말씀 대로 배송 은 매우 친절 하 시 ㅂ니다	<P>
무슨 장난 하 는 것 도 아니 고	<N>
웃 는 얼굴 로 배치 하 아 주 시 고 설명 하 아 주 시 어서 아주 감사히 배송 받 았 습니다	<P>
그래서 전후 사정 다 얘기 하 고 오늘 무슨 일 이 있 어도 꼭 배달 하 시 라 하 았 다	<N>
가격 대비 강추 하 ㅂ니다	<P>
먼지 가 가득 하 아서 걸레 질 을 하 게 만들 고 바꾸 어 달 라고 하 아도	<N>
다른 사람 들 이 말 하 기 ㄹ 쌓 ㄴ 드럼 세탁 기 는 소음 이 심하 고 빨래 가 통 돌 이 보다 잘 안 되 ㄴ다 하 아서 은근 이 걱정 하 았 는데 좋 습니다	<P>
말 을 말 아야지	<N>
세척력 은 몸 통 돌 이 많 은 못하 ㄴ 거 같 아도 빨래 가 꼬이 지 않 아서 참 좋 네요	<P>
어떤 세탁기 나 다 그렇 겠 지만 정말 마음 에 들 고 좋 습니다	<N>
다음날 바로 배송 이 되 어서 놀라 았 네요	<P>
일정 도 걸리 ㄴ 거 같 은 데 에 휴 좀 그렇 네요	<N>
드럼 이랑 많이 고민 하 았 는데 일반 으로 하 기 잘 하 ㄴ 듯	<P>
역시 삼성 이나 엘지 에 대우 이미지 가 뒤 치 어 지 는 이유 가 여기 에 있 구나 싶 더군 요	<N>
디자인 도 굿	<P>
어제 세탁기 받 고 저녁 에 돌리 어 보 았 는데 탈수 하 ㄹ 때 시간 이 계속 늘어나 아서 일단 오늘 대우 에서 해피콜 오 아서 얘기 하 니 방문 하 아 주 시 기 로 하 었 구	<N>
다음 에서 구입 하 지 ㄴ 않 았 지만 세탁기 가 너무 맘 에 들 어요	<P>
세탁기 물 공급 하 아 주 는 호스 가 저희 집 이랑 맞 지 를 않 아서 서비스 를 신청 을 하 었 는데요	<N>
첨 에 ㄴ 엘지 것 루 하 ㄹ려다가 친구 가 필터 가 좋 다 이 길래 맘 을 바꾸 어서 이것 으로 구입 하 았 는 데 이 요 매직 필 터 정말 좋 아요	<P>
판매자 분 은 기사 에게 미루 고 기사 는 책임 을 회피 하 고	<N>
옷 에 먼지 가 없이 깨끗 하 게 세탁 이 되 어서 놀랬답니다	<P>
그래서 오늘 환불 신청 을 하 었 더니 그것 마저 도 거절 하 네 요	<N>
은나노워시 기능 도 좋 구요	<P>
일안 에 환불 교환 가능 하 ㄴ 것 이 소비자 의 권리 이 ㄴ데 나몰라라 안 되 ㄴ다는 말 만 하 는데 화가 나 ㅂ니다	<N>
다 좋 아요	<P>
배송비 는 저희 가 부담 하 ㄹ 거 이 니까 환불 하 아 주 시 어요	<N>
어디 하나 나무라 ㄹ 때 가 없 어요	<P>
어제 기사 분 이 오 았 다 가 ㄴ 후 로 손 도 안 대 었 으니까 회수 하 아 가 시 어요	<N>
너무너무 좋 아요	<P>
배송 이 빠르 아서 좋 기 하지만 진열 되 ㄴ 상품 인 것 같 은 느낌 이 들 었 습니다	<N>
당근 좋 으리라 기대 하 ㅂ니다	<P>
상품 은 마음 에 들 어요	<N>
그리 고 설치 하 아 주 시 ㄴ 직원 분 친절 하 ㅁ 에 감동 먹 었 습니다	<P>
엄청시끄러움	<N>
대단히 만족 하 ㅂ니다	<P>
세탁기 입구 에 완전 깜댕이고좀 닦 아 주 던가 배송 미루 어 지 ㄴ다고 문자 만 번 오 고 다신 이용 하 고 싶 지 않 음	<N>
적극 추천 하 ㅂ니다	<P>
다소 늦 게 배송 되 리라는 전화 를 받 고 실망 하 면서 몇일 쌓이 ㄴ 빨래 를 발 로 밟 아 빨 고 몇일 을 이렇 게 하 아야 하 나 하 고 걱정 하 고 있 었 다	<N>
주문 후 일 만 에 도착 하 았 고 요 사용법 도 친절 하 게 기사 님 이 알리 어 주 시 고 가시 었 습니다	<P>
색깔 이 인터넷 보다 약간 어둡 ㄴ 감 이 있 어 조금 더 밝 은 은색흰색에 가 까운 이 었 으면 하 는 아쉬움 이외 에 는 아쉽 ㄴ 것 이 없 었 다	<N>
폐가 전 도 수거 부 탁 하 니 선뜻 가져가 시 네요	<P>
배송 정말 느립니다	<N>
완전 좋 아요	<P>
최고 로 느림	<N>
좋 은 세탁기 받 았 어요	<P>
대량 으로 세탁 하 아서 그러 ㄴ지 탈수 후 엉킴이 있고급수호스 길이 가 미터 이 라서 개인 적 으로 조금 짧 네요	<N>
나 ㄴ 난 완전 강강츄	<P>
일 날 구입 하 고 거의 주 째 기다리 고 있 습니다	<N>
대리점 보다 가격 도 많이 저렴 하 고 배송 도 엄청 빠르 네요	<P>
최대 일 이 면 되 ㄹ 듯이 얘기 하 아서 기다리 고 또 기다리 었 는 데 상 품 입 고 지연 이 라는 말 만 되풀이 하면 서 계속 하루 이틀 씩 늦추 고 이 었 네요	<N>
어머니 가 무엇 보다 좋아하 시 어서 저 도 만족 하 ㅂ니다	<P>
이번주 입 고도 사실 불투명 하 다는 뉘앙스 까지 풍기 고 지금 인터파크 에 엄청 컴프레인했습니다	<N>
고맙 습니다	<P>
상품 평 을 보 면 일 만 에 받 았 다느니 하 는 내용 들 이 있 어서 구매 하 았 는데 지금 생각 하 아 보 니 업체 에서 거짓 글 들 을 올려놓 은 거 같 네요	<N>
감사 하 게 잘 사용 하 겠 습니다	<P>
아무리 계산 하 아 보 아도 그날 짜 네 주문 하 아서 이틀 만 에 받 았 다는 것 ㄴ 말 도 안 되 ㅂ니다	<N>
빨래 도 않엉켜서 꺼내 기 넘 쉬 어 요	<P>
지금 저 같이 속 아서 계속 기다리 고 계 신분 들 은 인터파크 에 연락 하 아서 불만 접수 하 시 고 요	<N>
감솨	<P>
구매 하 ㄴ지 얼마 안 되 는 분 들 이 라면 빨랑 취소 하 시 어요	<N>
말 니 팔 시 구 항상 행복 하 시 어요	<P>
저 는 지금 어떤 조 치 를 취하 아야 하 나 잠시 고민중 이 ㅂ니다	<N>
대 만족 이 ㅂ니다	<P>
헉 오늘 도 또 이렇 게 시간 끌 기 로 들어가 는 거 같 네요	<N>
너무 좋 아 죽 겠 습니다	<P>
주문 하 고 제품 오 기 까 지 의 시간 이 좀 오래 걸리 는 것 같 습니다	<N>
배송도 빠르 구요	<P>
이 라는데 다르 ㄴ 제 품 보다 작 아 보 여 요	<N>
지정일 배송 이 라 좋 습니다	<P>
근데 이번 에 는 좀 늦 었 군요	<N>
대 박 제품 이 에요	<P>
연락 도 없이 일주 이 나 지나 아서 오 았 는데 물어니 재고 가 없 었 다고	<N>
대용량 이 라 괜찮 음	<P>
그러면 빨리 그렇 다고 하 시 던지	<N>
이불 빨래 도 잘 ?P>	<P>
말투 는 친절 하 ㄴ데 일 은 그다지 성의 가 없 음	<N>
대용량 이 라 괜찮 음	<P>
많이 바쁘 아서 그러 시 는지 는 모르 겠 는데 설치 도 건성	<N>
이불 빨래 도 잘 ?	<P>
질문 에 답 도 건성	<N>
친절 하 ㄴ 배송 감사 드리 어요	<P>
드럼 은 온수 를 쓰 지 못 하 아서 불편 하 았 어요	<N>
